Word,fq_No,prob_no,fq_Yes,prob_yes,fq_total
0,36496,0.11550378,534,0.001426602,37030
จันทร์,28,9.17777E-05,50,0.000135994,78
ม.ค.,0,3.16475E-06,101,0.000271988,101
มกราคม,0,3.16475E-06,46,0.000125328,46
กุมภาพันธ์,0,3.16475E-06,129,0.000346651,129
จ.,99,0.000316475,479,0.001279942,578
มีนาคม,0,3.16475E-06,36,9.86622E-05,36
ก.พ.,0,3.16475E-06,476,0.001271942,476
อังคาร,13,4.43065E-05,48,0.000130661,61
พฤหัสบดี,0,3.16475E-06,45,0.000122661,45
อ.,106,0.000338628,307,0.000821296,413
เม.ย.,0,3.16475E-06,45,0.000122661,45
ศ.,0,3.16475E-06,17,4.79978E-05,17
ส.,16,5.38007E-05,25,6.93302E-05,41
พุธ,13,4.43065E-05,19,5.33309E-05,32
ธันวาคม,108,0.000344957,35,9.59956E-05,143
พ.ค.,0,3.16475E-06,31,8.53295E-05,31
พ.ย.,11,3.7977E-05,21,5.8664E-05,32
ศุกร์,35,0.000113931,24,6.66636E-05,59
เสาร์,78,0.000250015,26,7.19967E-05,104
ธ.ค.,96,0.00030698,0,2.66655E-06,96
อาทิตย์,64,0.000205709,0,2.66655E-06,64
SUN,14,4.74712E-05,0,2.66655E-06,14
May,14,4.74712E-05,0,2.66655E-06,14
December,10,3.48122E-05,0,2.66655E-06,10
Dec,13,4.43065E-05,0,2.66655E-06,13
￼,0,3.16475E-06,20,5.59975E-05,20
��,10,3.48122E-05,0,2.66655E-06,10
',162,0.000515854,566,0.001511931,728
-,907,0.002873591,1334,0.003559839,2241
--,16,5.38007E-05,0,2.66655E-06,16
–,0,3.16475E-06,27,7.46633E-05,27
—,20,6.64597E-05,0,2.66655E-06,20
่,0,3.16475E-06,12,3.46651E-05,12
้,12,4.11417E-05,17,4.79978E-05,29
์,175,0.000556996,230,0.000615972,405
์',0,3.16475E-06,13,3.73316E-05,13
️⃣,14,4.74712E-05,0,2.66655E-06,14
 ,53,0.000170896,19,5.33309E-05,72
 #,31,0.000101272,0,2.66655E-06,31
"
",0,3.16475E-06,35470,0.094585045,35470
​,773,0.002449514,768,0.002050574,1541
​#,44,0.000142414,0,2.66655E-06,44
!,203,0.000645608,405,0.001082618,608
‼,0,3.16475E-06,19,5.33309E-05,19
‼️,0,3.16475E-06,10,2.9332E-05,10
!!,188,0.000598137,370,0.000989288,558
!!!,140,0.000446229,98,0.000263988,238
!!!!,76,0.000243686,11,3.19985E-05,87
!!!!!,25,8.22834E-05,0,2.66655E-06,25
!!!!!!,11,3.7977E-05,0,2.66655E-06,11
!!..,0,3.16475E-06,11,3.19985E-05,11
"""",7123,0.022545659,7939,0.021172374,15062
"์""",0,3.16475E-06,22,6.13306E-05,22
"""""",319,0.001012719,1125,0.003002531,1444
"""""""",24,7.91187E-05,0,2.66655E-06,24
"""""🇹🇭",0,3.16475E-06,14,3.99982E-05,14
"""#",272,0.000863976,90,0.000242656,362
"""?",16,5.38007E-05,0,2.66655E-06,16
"""??",107,0.000341793,0,2.66655E-06,107
"""????",32,0.000104437,0,2.66655E-06,32
"""@",182,0.000579149,123,0.000330652,305
"""[",20,6.64597E-05,0,2.66655E-06,20
"""“",20,6.64597E-05,0,2.66655E-06,20
"""ขอ",19,6.32949E-05,0,2.66655E-06,19
"""คน",19,6.32949E-05,0,2.66655E-06,19
#,14721,0.046591409,7511,0.020031092,22232
#?,13,4.43065E-05,0,2.66655E-06,13
#??,54,0.000174061,0,2.66655E-06,54
#???,51,0.000164567,0,2.66655E-06,51
#????,20,6.64597E-05,0,2.66655E-06,20
#…,0,3.16475E-06,11,3.19985E-05,11
"#…""",0,3.16475E-06,36,9.86622E-05,36
#ขอ,0,3.16475E-06,21,5.8664E-05,21
#ขุณ,22,7.27892E-05,0,2.66655E-06,22
#คน,23,7.59539E-05,0,2.66655E-06,23
#คอล,12,4.11417E-05,0,2.66655E-06,12
#คําคม,53,0.000170896,0,2.66655E-06,53
#น้ํา,33,0.000107601,0,2.66655E-06,33
#ไบร์,106,0.000338628,0,2.66655E-06,106
#ผบทบ,0,3.16475E-06,13,3.73316E-05,13
#พ,14,4.74712E-05,0,2.66655E-06,14
"#พร…""",0,3.16475E-06,10,2.9332E-05,10
#หยิ่น,28,9.17777E-05,0,2.66655E-06,28
#อ,0,3.16475E-06,13,3.73316E-05,13
%,94,0.000300651,31,8.53295E-05,125
&,81,0.000259509,54,0.00014666,135
—&,0,3.16475E-06,12,3.46651E-05,12
(,449,0.001424136,512,0.001367938,961
((,16,5.38007E-05,0,2.66655E-06,16
(@,35,0.000113931,0,2.66655E-06,35
),441,0.001398818,521,0.001391937,962
)),18,6.01302E-05,0,2.66655E-06,18
)@,12,4.11417E-05,0,2.66655E-06,12
*,84,0.000269004,10,2.9332E-05,94
**,63,0.000202544,14,3.99982E-05,77
",",194,0.000617126,175,0.000469312,369
",ผวจ…""",0,3.16475E-06,11,3.19985E-05,11
.,9166,0.029011238,5889,0.015705955,15055
.​,0,3.16475E-06,15,4.26647E-05,15
..,467,0.001481102,624,0.001666591,1091
...,477,0.001512749,442,0.00118128,919
....,113,0.000360781,129,0.000346651,242
.....,28,9.17777E-05,45,0.000122661,73
......,11,3.7977E-05,0,2.66655E-06,11
.........,0,3.16475E-06,13,3.73316E-05,13
..........,0,3.16475E-06,19,5.33309E-05,19
..??,17,5.69655E-05,0,2.66655E-06,17
.????,11,3.7977E-05,0,2.66655E-06,11
.…,0,3.16475E-06,13,3.73316E-05,13
".…""",0,3.16475E-06,49,0.000133327,49
.ท,0,3.16475E-06,12,3.46651E-05,12
.ทพ.,0,3.16475E-06,36,9.86622E-05,36
.ฝ,0,3.16475E-06,23,6.39971E-05,23
｡ﾟ,14,4.74712E-05,0,2.66655E-06,14
｡ﾟ⊹,14,4.74712E-05,0,2.66655E-06,14
/,8714,0.027580772,4844,0.012919414,13558
//,74,0.000237356,0,2.66655E-06,74
/…,0,3.16475E-06,23,6.39971E-05,23
"/…""",0,3.16475E-06,79,0.000213324,79
/ศบภ.ม,0,3.16475E-06,50,0.000135994,50
:,657,0.002082404,11061,0.029497329,11718
:),14,4.74712E-05,0,2.66655E-06,14
://,8299,0.026267402,4974,0.013266065,13273
://…,0,3.16475E-06,14,3.99982E-05,14
"://…""",0,3.16475E-06,66,0.000178659,66
":/…""",0,3.16475E-06,35,9.59956E-05,35
::,11,3.7977E-05,0,2.66655E-06,11
:…,0,3.16475E-06,20,5.59975E-05,20
":…""",0,3.16475E-06,25,6.93302E-05,25
;,47,0.000151908,63,0.000170659,110
;&,0,3.16475E-06,13,3.73316E-05,13
?,1364,0.00431988,208,0.000557308,1572
?#,21,6.96244E-05,0,2.66655E-06,21
??,2379,0.007532098,30,8.26629E-05,2409
"??""",65,0.000208873,0,2.66655E-06,65
??#,46,0.000148743,0,2.66655E-06,46
??%,10,3.48122E-05,0,2.66655E-06,10
??:,31,0.000101272,0,2.66655E-06,31
???,192,0.000610796,15,4.26647E-05,207
????,739,0.002341913,0,2.66655E-06,739
"????""",12,4.11417E-05,0,2.66655E-06,12
????#,18,6.01302E-05,0,2.66655E-06,18
?????,79,0.00025318,0,2.66655E-06,79
??????,464,0.001471607,0,2.66655E-06,464
"??????""",11,3.7977E-05,0,2.66655E-06,11
??????#,12,4.11417E-05,0,2.66655E-06,12
???????,38,0.000123425,0,2.66655E-06,38
????????,135,0.000430406,0,2.66655E-06,135
?????????,11,3.7977E-05,0,2.66655E-06,11
??????????,83,0.000265839,0,2.66655E-06,83
????????????,34,0.000110766,0,2.66655E-06,34
??????????????,29,9.49424E-05,0,2.66655E-06,29
????????????????,18,6.01302E-05,0,2.66655E-06,18
??????????????????,10,3.48122E-05,0,2.66655E-06,10
????????????????????,10,3.48122E-05,0,2.66655E-06,10
@,9199,0.029115675,20065,0.053506908,29264
@_,57,0.000183555,0,2.66655E-06,57
@__,10,3.48122E-05,0,2.66655E-06,10
[,15,5.0636E-05,27,7.46633E-05,42
],44,0.000142414,25,6.93302E-05,69
^,10,3.48122E-05,0,2.66655E-06,10
^^,34,0.000110766,11,3.19985E-05,45
_,2417,0.007652359,6448,0.017196554,8865
_:,0,3.16475E-06,21,5.8664E-05,21
__,62,0.000199379,18,5.06644E-05,80
___,10,3.48122E-05,0,2.66655E-06,10
|,53,0.000170896,72,0.000194658,125
~,60,0.00019305,0,2.66655E-06,60
~~,13,4.43065E-05,0,2.66655E-06,13
‘,21,6.96244E-05,137,0.000367983,158
’,59,0.000189885,150,0.000402648,209
“,117,0.00037344,1788,0.00477045,1905
“ผม,0,3.16475E-06,21,5.8664E-05,21
“ม,0,3.16475E-06,53,0.000143993,53
”,105,0.000335463,1991,0.005311759,2096
์”,0,3.16475E-06,14,3.99982E-05,14
"”…""",0,3.16475E-06,16,4.53313E-05,16
฿,86,0.000275333,0,2.66655E-06,86
+,142,0.000452559,423,0.001130615,565
<,11,3.7977E-05,0,2.66655E-06,11
=,60,0.00019305,0,2.66655E-06,60
>,16,5.38007E-05,0,2.66655E-06,16
><,18,6.01302E-05,0,2.66655E-06,18
>>,14,4.74712E-05,0,2.66655E-06,14
⊹,14,4.74712E-05,0,2.66655E-06,14
◦,0,3.16475E-06,20,5.59975E-05,20
…,0,3.16475E-06,2200,0.005869067,2200
"…""",0,3.16475E-06,2814,0.007506326,2814
☎️,15,5.0636E-05,16,4.53313E-05,31
☑️,22,7.27892E-05,0,2.66655E-06,22
☺️,20,6.64597E-05,0,2.66655E-06,20
✔,10,3.48122E-05,0,2.66655E-06,10
❤,13,4.43065E-05,0,2.66655E-06,13
❤️,58,0.00018672,14,3.99982E-05,72
✅,22,7.27892E-05,0,2.66655E-06,22
✨,16,5.38007E-05,0,2.66655E-06,16
•,42,0.000136084,14,3.99982E-05,56
0,1118,0.003541352,820,0.002189234,1938
0,75,0.000240521,16,4.53313E-05,91
1,36,0.000117096,0,2.66655E-06,36
1,17,5.69655E-05,0,2.66655E-06,17
1170751,14,4.74712E-05,0,2.66655E-06,14
18,0,3.16475E-06,71,0.000191991,71
2,34,0.000110766,309,0.000826629,343
3,11,3.7977E-05,12,3.46651E-05,23
4,37,0.00012026,0,2.66655E-06,37
5,37,0.00012026,16,4.53313E-05,53
6,14,4.74712E-05,0,2.66655E-06,14
651055524,13,4.43065E-05,0,2.66655E-06,13
7,20,6.64597E-05,39,0.000106662,59
8,10,3.48122E-05,0,2.66655E-06,10
80,18,6.01302E-05,0,2.66655E-06,18
804199298,12,4.11417E-05,0,2.66655E-06,12
9,32,0.000104437,24,6.66636E-05,56
9,12,4.11417E-05,14,3.99982E-05,26
90,16,5.38007E-05,0,2.66655E-06,16
98,10,3.48122E-05,0,2.66655E-06,10
1,2108,0.006674452,2920,0.00778898,5028
๑,0,3.16475E-06,51,0.00013866,51
"1,000",0,3.16475E-06,31,8.53295E-05,31
"1,620",0,3.16475E-06,20,5.59975E-05,20
1,18,6.01302E-05,43,0.000117328,61
10,252,0.000800681,219,0.00058664,471
10,33,0.000107601,22,6.13306E-05,55
10.3,0,3.16475E-06,12,3.46651E-05,12
100,115,0.000367111,71,0.000191991,186
1000,39,0.00012659,0,2.66655E-06,39
10000,14,4.74712E-05,0,2.66655E-06,14
101,14,4.74712E-05,0,2.66655E-06,14
105,0,3.16475E-06,13,3.73316E-05,13
11,140,0.000446229,147,0.000394649,287
112233,0,3.16475E-06,48,0.000130661,48
12,136,0.00043357,251,0.00067197,387
"๑๒,",0,3.16475E-06,12,3.46651E-05,12
120,0,3.16475E-06,32,8.7996E-05,32
1204,14,4.74712E-05,0,2.66655E-06,14
1212,11,3.7977E-05,0,2.66655E-06,11
123,16,5.38007E-05,0,2.66655E-06,16
127,18,6.01302E-05,0,2.66655E-06,18
13,77,0.00024685,147,0.000394649,224
13,0,3.16475E-06,19,5.33309E-05,19
130,10,3.48122E-05,0,2.66655E-06,10
1300,14,4.74712E-05,0,2.66655E-06,14
1300,13,4.43065E-05,0,2.66655E-06,13
132,0,3.16475E-06,11,3.19985E-05,11
138,0,3.16475E-06,19,5.33309E-05,19
14,55,0.000177226,61,0.000165326,116
1400,14,4.74712E-05,0,2.66655E-06,14
15,95,0.000303816,105,0.000282654,200
150,11,3.7977E-05,0,2.66655E-06,11
1500,31,0.000101272,0,2.66655E-06,31
16,44,0.000142414,133,0.000357317,177
16,0,3.16475E-06,24,6.66636E-05,24
160,18,6.01302E-05,0,2.66655E-06,18
1606,11,3.7977E-05,0,2.66655E-06,11
17,60,0.00019305,170,0.000455979,230
170,10,3.48122E-05,0,2.66655E-06,10
18,92,0.000294321,165,0.000442647,257
18,13,4.43065E-05,0,2.66655E-06,13
180,11,3.7977E-05,0,2.66655E-06,11
19,117,0.00037344,369,0.000986622,486
๑๙,0,3.16475E-06,13,3.73316E-05,13
191,0,3.16475E-06,25,6.93302E-05,25
1969,0,3.16475E-06,27,7.46633E-05,27
1977,18,6.01302E-05,0,2.66655E-06,18
1978,0,3.16475E-06,13,3.73316E-05,13
1990,11,3.7977E-05,0,2.66655E-06,11
1998,0,3.16475E-06,51,0.00013866,51
2,1780,0.005636415,3975,0.010602186,5755
๒,0,3.16475E-06,27,7.46633E-05,27
"2,000",0,3.16475E-06,18,5.06644E-05,18
2,13,4.43065E-05,37,0.000101329,50
2.5,0,3.16475E-06,110,0.000295987,110
20,104,0.000332298,117,0.000314652,221
20,13,4.43065E-05,0,2.66655E-06,13
20.2,13,4.43065E-05,0,2.66655E-06,13
200,35,0.000113931,18,5.06644E-05,53
2000,12,4.11417E-05,0,2.66655E-06,12
201204,20,6.64597E-05,0,2.66655E-06,20
2014,0,3.16475E-06,43,0.000117328,43
2018,11,3.7977E-05,0,2.66655E-06,11
2019,19,6.32949E-05,158,0.000423981,177
2020,291,0.000924106,228,0.000610639,519
2020.12.06,11,3.7977E-05,0,2.66655E-06,11
2021,22,7.27892E-05,0,2.66655E-06,22
207,0,3.16475E-06,28,7.73298E-05,28
21,65,0.000208873,214,0.000573307,279
๒๑,0,3.16475E-06,103,0.000277321,103
21.3,0,3.16475E-06,10,2.9332E-05,10
22,46,0.000148743,182,0.000487978,228
23,85,0.000272168,75,0.000202657,160
๒๓,0,3.16475E-06,12,3.46651E-05,12
23.59,10,3.48122E-05,0,2.66655E-06,10
2355,0,3.16475E-06,31,8.53295E-05,31
24,68,0.000218368,178,0.000477312,246
"24,000",0,3.16475E-06,10,2.9332E-05,10
24,12,4.11417E-05,0,2.66655E-06,12
241,0,3.16475E-06,213,0.000570641,213
24211,14,4.74712E-05,0,2.66655E-06,14
2427,13,4.43065E-05,0,2.66655E-06,13
24745488,0,3.16475E-06,202,0.000541309,202
2475,0,3.16475E-06,39,0.000106662,39
25,57,0.000183555,179,0.000479978,236
250,11,3.7977E-05,0,2.66655E-06,11
2511,0,3.16475E-06,61,0.000165326,61
2557,0,3.16475E-06,20,5.59975E-05,20
2560,20,6.64597E-05,0,2.66655E-06,20
2562,0,3.16475E-06,83,0.00022399,83
๒๕๖๒,0,3.16475E-06,39,0.000106662,39
2563,77,0.00024685,166,0.000445313,243
๒๕๖๓,13,4.43065E-05,0,2.66655E-06,13
2564,11,3.7977E-05,0,2.66655E-06,11
26,56,0.000180391,65,0.000175992,121
27,58,0.00018672,28,7.73298E-05,86
28,56,0.000180391,157,0.000421314,213
2844,0,3.16475E-06,25,6.93302E-05,25
29,96,0.00030698,52,0.000141327,148
29027652,10,3.48122E-05,0,2.66655E-06,10
3,1480,0.004686991,1716,0.004578459,3196
๓,0,3.16475E-06,117,0.000314652,117
3,11,3.7977E-05,11,3.19985E-05,22
30,91,0.000291157,110,0.000295987,201
"30,000",0,3.16475E-06,24,6.66636E-05,24
300,37,0.00012026,0,2.66655E-06,37
302,0,3.16475E-06,20,5.59975E-05,20
3022,0,3.16475E-06,18,5.06644E-05,18
3028,11,3.7977E-05,0,2.66655E-06,11
309,0,3.16475E-06,30,8.26629E-05,30
31,51,0.000164567,79,0.000213324,130
32,37,0.00012026,53,0.000143993,90
321,16,5.38007E-05,0,2.66655E-06,16
33,66,0.000212038,37,0.000101329,103
333,16,5.38007E-05,0,2.66655E-06,16
34,35,0.000113931,31,8.53295E-05,66
340,11,3.7977E-05,0,2.66655E-06,11
34498437,0,3.16475E-06,19,5.33309E-05,19
35,38,0.000123425,23,6.39971E-05,61
353,0,3.16475E-06,15,4.26647E-05,15
356,29,9.49424E-05,0,2.66655E-06,29
36,40,0.000129755,200,0.000535976,240
"36,0",0,3.16475E-06,20,5.59975E-05,20
37,23,7.59539E-05,12,3.46651E-05,35
38,26,8.54482E-05,10,2.9332E-05,36
39,31,0.000101272,45,0.000122661,76
4,1441,0.004563566,1410,0.003762496,2851
๔,0,3.16475E-06,15,4.26647E-05,15
4,0,3.16475E-06,14,3.99982E-05,14
40,75,0.000240521,43,0.000117328,118
400,12,4.11417E-05,0,2.66655E-06,12
41,13,4.43065E-05,19,5.33309E-05,32
42,33,0.000107601,35,9.59956E-05,68
43,36,0.000117096,11,3.19985E-05,47
44,20,6.64597E-05,10,2.9332E-05,30
45,28,9.17777E-05,31,8.53295E-05,59
"45,000",0,3.16475E-06,18,5.06644E-05,18
46,23,7.59539E-05,12,3.46651E-05,35
47,15,5.0636E-05,0,2.66655E-06,15
477,0,3.16475E-06,28,7.73298E-05,28
48,160,0.000509524,48,0.000130661,208
49,20,6.64597E-05,11,3.19985E-05,31
4914,0,3.16475E-06,12,3.46651E-05,12
5,1437,0.004550907,1007,0.002687878,2444
๕,29,9.49424E-05,14,3.99982E-05,43
50,106,0.000338628,18,5.06644E-05,124
500,33,0.000107601,0,2.66655E-06,33
51,23,7.59539E-05,0,2.66655E-06,23
52,32,0.000104437,10,2.9332E-05,42
53,19,6.32949E-05,19,5.33309E-05,38
53234935,0,3.16475E-06,30,8.26629E-05,30
54,23,7.59539E-05,13,3.73316E-05,36
55,143,0.000455724,38,0.000103995,181
555,460,0.001458948,132,0.000354651,592
5555,375,0.001189945,93,0.000250655,468
55555,216,0.00068675,34,9.33291E-05,250
555555,117,0.00037344,12,3.46651E-05,129
5555555,95,0.000303816,0,2.66655E-06,95
55555555,64,0.000205709,0,2.66655E-06,64
555555555,55,0.000177226,0,2.66655E-06,55
5555555555,48,0.000155073,0,2.66655E-06,48
55555555555,32,0.000104437,0,2.66655E-06,32
5.55556E+11,23,7.59539E-05,0,2.66655E-06,23
5.55556E+12,13,4.43065E-05,0,2.66655E-06,13
5.55556E+13,13,4.43065E-05,0,2.66655E-06,13
5.55556E+14,13,4.43065E-05,0,2.66655E-06,13
56,34,0.000110766,0,2.66655E-06,34
57,16,5.38007E-05,15,4.26647E-05,31
58,23,7.59539E-05,21,5.8664E-05,44
59,35,0.000113931,16,4.53313E-05,51
6,1136,0.003598318,1138,0.003037196,2274
"๖,๐๐๐",0,3.16475E-06,58,0.000157326,58
60,33,0.000107601,18,5.06644E-05,51
61,20,6.64597E-05,15,4.26647E-05,35
611,0,3.16475E-06,12,3.46651E-05,12
62,13,4.43065E-05,138,0.00037065,151
6234735,13,4.43065E-05,0,2.66655E-06,13
625,21,6.96244E-05,0,2.66655E-06,21
63,99,0.000316475,549,0.0014666,648
๖๓,0,3.16475E-06,56,0.000151993,56
64,25,8.22834E-05,17,4.79978E-05,42
64572567,0,3.16475E-06,25,6.93302E-05,25
65,35,0.000113931,17,4.79978E-05,52
66,20,6.64597E-05,0,2.66655E-06,20
67,12,4.11417E-05,0,2.66655E-06,12
68,22,7.27892E-05,0,2.66655E-06,22
69,116,0.000370275,27,7.46633E-05,143
7,1861,0.005892759,875,0.002335894,2736
70,41,0.000132919,51,0.00013866,92
702,15,5.0636E-05,0,2.66655E-06,15
71,14,4.74712E-05,174,0.000466646,188
72,19,6.32949E-05,15,4.26647E-05,34
73,21,6.96244E-05,15,4.26647E-05,36
7330,0,3.16475E-06,71,0.000191991,71
74,0,3.16475E-06,10,2.9332E-05,10
75,26,8.54482E-05,29,7.99964E-05,55
76,27,8.86129E-05,0,2.66655E-06,27
77,14,4.74712E-05,18,5.06644E-05,32
78,14,4.74712E-05,10,2.9332E-05,24
789,0,3.16475E-06,24,6.66636E-05,24
79,25,8.22834E-05,0,2.66655E-06,25
8,1215,0.003848333,915,0.002442556,2130
80,30,9.81072E-05,21,5.8664E-05,51
800,70,0.000224697,0,2.66655E-06,70
81,12,4.11417E-05,28,7.73298E-05,40
82,12,4.11417E-05,0,2.66655E-06,12
83,17,5.69655E-05,10,2.9332E-05,27
84,16,5.38007E-05,23,6.39971E-05,39
85,15,5.0636E-05,0,2.66655E-06,15
852,10,3.48122E-05,0,2.66655E-06,10
86,20,6.64597E-05,0,2.66655E-06,20
869,0,3.16475E-06,10,2.9332E-05,10
87,15,5.0636E-05,0,2.66655E-06,15
88,32,0.000104437,0,2.66655E-06,32
888,13,4.43065E-05,0,2.66655E-06,13
89,30,9.81072E-05,0,2.66655E-06,30
9,1336,0.004231267,846,0.002258564,2182
๙,27,8.86129E-05,11,3.19985E-05,38
90,30,9.81072E-05,29,7.99964E-05,59
900,11,3.7977E-05,0,2.66655E-06,11
904,0,3.16475E-06,74,0.000199991,74
91,25,8.22834E-05,57,0.00015466,82
916,54,0.000174061,0,2.66655E-06,54
92,43,0.000139249,0,2.66655E-06,43
9298,12,4.11417E-05,0,2.66655E-06,12
93,16,5.38007E-05,0,2.66655E-06,16
94,34,0.000110766,20,5.59975E-05,54
95,27,8.86129E-05,0,2.66655E-06,27
96,39,0.00012659,18,5.06644E-05,57
97,31,0.000101272,12,3.46651E-05,43
98,27,8.86129E-05,0,2.66655E-06,27
989,15,5.0636E-05,0,2.66655E-06,15
๙๘๙,12,4.11417E-05,0,2.66655E-06,12
99,81,0.000259509,19,5.33309E-05,100
9911,13,4.43065E-05,0,2.66655E-06,13
999,16,5.38007E-05,0,2.66655E-06,16
a,334,0.00106019,342,0.000914625,676
AAmornsrisang,0,3.16475E-06,15,4.26647E-05,15
AB,12,4.11417E-05,0,2.66655E-06,12
aBA,0,3.16475E-06,15,4.26647E-05,15
Ae,10,3.48122E-05,0,2.66655E-06,10
aekPUBS,0,3.16475E-06,52,0.000141327,52
AFNCThailand,0,3.16475E-06,69,0.000186658,69
AIS,0,3.16475E-06,10,2.9332E-05,10
ake,0,3.16475E-06,13,3.73316E-05,13
Alitsarah,0,3.16475E-06,88,0.000237323,88
AlwaysNoon,11,3.7977E-05,0,2.66655E-06,11
Am,0,3.16475E-06,11,3.19985E-05,11
AmaratJeab,0,3.16475E-06,75,0.000202657,75
AmDaengPrapi,0,3.16475E-06,88,0.000237323,88
amitaputt,10,3.48122E-05,0,2.66655E-06,10
amp,11,3.7977E-05,35,9.59956E-05,46
an,15,5.0636E-05,0,2.66655E-06,15
and,31,0.000101272,38,0.000103995,69
annpiyaa,0,3.16475E-06,10,2.9332E-05,10
anw,67,0.000215203,0,2.66655E-06,67
Ao,16,5.38007E-05,15,4.26647E-05,31
aorwiki,0,3.16475E-06,29,7.99964E-05,29
apad,0,3.16475E-06,12,3.46651E-05,12
Apple,13,4.43065E-05,0,2.66655E-06,13
appleM,11,3.7977E-05,0,2.66655E-06,11
Application,10,3.48122E-05,0,2.66655E-06,10
are,13,4.43065E-05,20,5.59975E-05,33
Area,0,3.16475E-06,782,0.002087905,782
arm,0,3.16475E-06,16,4.53313E-05,16
ARMdhiravath,0,3.16475E-06,203,0.000543975,203
army,0,3.16475E-06,3078,0.008210294,3078
ARMYLAND,0,3.16475E-06,13,3.73316E-05,13
armypr,0,3.16475E-06,1559,0.004159811,1559
ARMYSTRONG,0,3.16475E-06,11,3.19985E-05,11
ArmyYamo,0,3.16475E-06,20,5.59975E-05,20
aroii,17,5.69655E-05,0,2.66655E-06,17
art,11,3.7977E-05,0,2.66655E-06,11
as,11,3.7977E-05,0,2.66655E-06,11
ASgvWFSkxbXGQhHUjGMDApsQ,0,3.16475E-06,18,5.06644E-05,18
at,72,0.000231027,15,4.26647E-05,87
aviknowledge,0,3.16475E-06,10,2.9332E-05,10
aX,10,3.48122E-05,0,2.66655E-06,10
b,189,0.000601302,168,0.000450646,357
baby,11,3.7977E-05,0,2.66655E-06,11
babysbreath,17,5.69655E-05,0,2.66655E-06,17
BAf,0,3.16475E-06,27,7.46633E-05,27
BamBam,181,0.000575984,0,2.66655E-06,181
Bangkok,42,0.000136084,0,2.66655E-06,42
Bank,20,6.64597E-05,0,2.66655E-06,20
Barge,0,3.16475E-06,17,4.79978E-05,17
basementkaraok,0,3.16475E-06,12,3.46651E-05,12
basjtr,19,6.32949E-05,0,2.66655E-06,19
BB,55,0.000177226,17,4.79978E-05,72
BbizxiEQC,0,3.16475E-06,10,2.9332E-05,10
bbrightvc,255,0.000810175,0,2.66655E-06,255
BC,11,3.7977E-05,0,2.66655E-06,11
BcommanderTH,0,3.16475E-06,13,3.73316E-05,13
Bdb,0,3.16475E-06,43,0.000117328,43
bE,25,8.22834E-05,19,5.33309E-05,44
Bench,0,3.16475E-06,15,4.26647E-05,15
BenchaFWP,0,3.16475E-06,15,4.26647E-05,15
Best,19,6.32949E-05,0,2.66655E-06,19
bimun,25,8.22834E-05,0,2.66655E-06,25
Birthday,12,4.11417E-05,0,2.66655E-06,12
bkk,11,3.7977E-05,0,2.66655E-06,11
Black,12,4.11417E-05,0,2.66655E-06,12
BLACKPINK,19,6.32949E-05,0,2.66655E-06,19
Blocker,10,3.48122E-05,0,2.66655E-06,10
BNK,39,0.00012659,0,2.66655E-06,39
bO,16,5.38007E-05,0,2.66655E-06,16
bodindecha,0,3.16475E-06,24,6.66636E-05,24
bonnadol,10,3.48122E-05,0,2.66655E-06,10
boworn,0,3.16475E-06,213,0.000570641,213
Bowz,0,3.16475E-06,43,0.000117328,43
BPAw,0,3.16475E-06,27,7.46633E-05,27
Br,10,3.48122E-05,0,2.66655E-06,10
BREAKING,0,3.16475E-06,12,3.46651E-05,12
Breath,42,0.000136084,0,2.66655E-06,42
BreathLastPiece,40,0.000129755,0,2.66655E-06,40
BreathofLove,39,0.00012659,0,2.66655E-06,39
bright,17,5.69655E-05,0,2.66655E-06,17
BrightTodayTh,0,3.16475E-06,14,3.99982E-05,14
BrightWinManilaLIVE,213,0.000677256,0,2.66655E-06,213
BS,10,3.48122E-05,0,2.66655E-06,10
BTS,121,0.000386099,70,0.000189325,191
by,32,0.000104437,19,5.33309E-05,51
bz,11,3.7977E-05,0,2.66655E-06,11
C,181,0.000575984,210,0.000562641,391
Ca,10,3.48122E-05,0,2.66655E-06,10
Cafe,35,0.000113931,0,2.66655E-06,35
Call,0,3.16475E-06,21,5.8664E-05,21
cb,11,3.7977E-05,0,2.66655E-06,11
cc,38,0.000123425,0,2.66655E-06,38
CD,0,3.16475E-06,20,5.59975E-05,20
CDKY,0,3.16475E-06,15,4.26647E-05,15
Center,0,3.16475E-06,21,5.8664E-05,21
CF,13,4.43065E-05,0,2.66655E-06,13
CGM,46,0.000148743,0,2.66655E-06,46
CH,21,6.96244E-05,25,6.93302E-05,46
chad,0,3.16475E-06,30,8.26629E-05,30
ChangeThailand,0,3.16475E-06,17,4.79978E-05,17
chernorris,0,3.16475E-06,16,4.53313E-05,16
chiangmai,11,3.7977E-05,0,2.66655E-06,11
Ck,18,6.01302E-05,0,2.66655E-06,18
ClCmHl,0,3.16475E-06,10,2.9332E-05,10
cm,16,5.38007E-05,0,2.66655E-06,16
CNX,21,6.96244E-05,0,2.66655E-06,21
co,8302,0.026276896,4835,0.012895415,13137
Cobra,0,3.16475E-06,23,6.39971E-05,23
Code,19,6.32949E-05,0,2.66655E-06,19
Combat,0,3.16475E-06,18,5.06644E-05,18
Coming,0,3.16475E-06,10,2.9332E-05,10
Commander,0,3.16475E-06,12,3.46651E-05,12
consernews,0,3.16475E-06,123,0.000330652,123
cooking,16,5.38007E-05,0,2.66655E-06,16
coronavirus,0,3.16475E-06,10,2.9332E-05,10
COVID,22,7.27892E-05,100,0.000269321,122
COVID-,0,3.16475E-06,64,0.000173325,64
cr,68,0.000218368,36,9.86622E-05,104
Crazyz,0,3.16475E-06,43,0.000117328,43
CSDThailand,0,3.16475E-06,15,4.26647E-05,15
CTRPANUWAT,11,3.7977E-05,0,2.66655E-06,11
cumkom,0,3.16475E-06,13,3.73316E-05,13
cyugala,0,3.16475E-06,12,3.46651E-05,12
cz,12,4.11417E-05,0,2.66655E-06,12
D,229,0.000727892,89,0.000239989,318
Dadjarit,0,3.16475E-06,21,5.8664E-05,21
DailynewsTwit,0,3.16475E-06,18,5.06644E-05,18
Dark,14,4.74712E-05,0,2.66655E-06,14
Day,40,0.000129755,18,5.06644E-05,58
dayrajchanshare,0,3.16475E-06,69,0.000186658,69
dbBXhcpilh,0,3.16475E-06,18,5.06644E-05,18
dbIE,0,3.16475E-06,11,3.19985E-05,11
de,0,3.16475E-06,11,3.19985E-05,11
dee,15,5.0636E-05,0,2.66655E-06,15
deer,13,4.43065E-05,0,2.66655E-06,13
Demm,0,3.16475E-06,48,0.000130661,48
DestinyClinicxMss,93,0.000297486,0,2.66655E-06,93
DestinyNeverAlone,18,6.01302E-05,0,2.66655E-06,18
di,11,3.7977E-05,0,2.66655E-06,11
DIV,0,3.16475E-06,106,0.00028532,106
DjOy,0,3.16475E-06,12,3.46651E-05,12
Dk,10,3.48122E-05,0,2.66655E-06,10
dkQ,0,3.16475E-06,11,3.19985E-05,11
Dm,149,0.000474712,14,3.99982E-05,163
dO,0,3.16475E-06,11,3.19985E-05,11
dok,0,3.16475E-06,11,3.19985E-05,11
drama,12,4.11417E-05,347,0.000927958,359
DrNarumonP,0,3.16475E-06,55,0.000149327,55
DrnewSuphanat,0,3.16475E-06,15,4.26647E-05,15
dSEB,0,3.16475E-06,11,3.19985E-05,11
dT,10,3.48122E-05,0,2.66655E-06,10
e,170,0.000541172,167,0.00044798,337
eCGn,0,3.16475E-06,74,0.000199991,74
ecsuRDO,0,3.16475E-06,24,6.66636E-05,24
eE,0,3.16475E-06,38,0.000103995,38
EfAKuw,0,3.16475E-06,159,0.000426647,159
eger,0,3.16475E-06,25,6.93302E-05,25
EJanNews,0,3.16475E-06,37,0.000101329,37
elsiamth,0,3.16475E-06,12,3.46651E-05,12
EMS,19,6.32949E-05,0,2.66655E-06,19
EP,149,0.000474712,24,6.66636E-05,173
Er,10,3.48122E-05,0,2.66655E-06,10
EsBCS,0,3.16475E-06,43,0.000117328,43
EU,0,3.16475E-06,12,3.46651E-05,12
EWGVyl,0,3.16475E-06,13,3.73316E-05,13
eWtsntBt,0,3.16475E-06,15,4.26647E-05,15
EX,0,3.16475E-06,10,2.9332E-05,10
f,202,0.000642444,130,0.000349317,332
face,0,3.16475E-06,16,4.53313E-05,16
FACEBOOK,0,3.16475E-06,20,5.59975E-05,20
fai,17,5.69655E-05,0,2.66655E-06,17
fake,0,3.16475E-06,37,0.000101329,37
FapQRVE,0,3.16475E-06,74,0.000199991,74
FashionIsland,19,6.32949E-05,0,2.66655E-06,19
FB,27,8.86129E-05,0,2.66655E-06,27
FC,18,6.01302E-05,0,2.66655E-06,18
FCRMP,0,3.16475E-06,216,0.00057864,216
Feelgoodmassag,12,4.11417E-05,0,2.66655E-06,12
fellerian,12,4.11417E-05,0,2.66655E-06,12
FhPI,0,3.16475E-06,12,3.46651E-05,12
FightInProcess,0,3.16475E-06,33,9.06626E-05,33
FirstStage,40,0.000129755,0,2.66655E-06,40
Fitness,0,3.16475E-06,16,4.53313E-05,16
FLYHIGHxMINTMAGTH,10,3.48122E-05,0,2.66655E-06,10
fm,10,3.48122E-05,56,0.000151993,66
food,11,3.7977E-05,0,2.66655E-06,11
for,44,0.000142414,26,7.19967E-05,70
fqNbaUiwCbBUFuJ,0,3.16475E-06,159,0.000426647,159
freesize,14,4.74712E-05,0,2.66655E-06,14
from,12,4.11417E-05,0,2.66655E-06,12
fs,11,3.7977E-05,0,2.66655E-06,11
FsDjoeacCywB,0,3.16475E-06,159,0.000426647,159
fsginzM,0,3.16475E-06,10,2.9332E-05,10
FSJ,0,3.16475E-06,17,4.79978E-05,17
ft,10,3.48122E-05,0,2.66655E-06,10
FUHrB,15,5.0636E-05,0,2.66655E-06,15
FULL,0,3.16475E-06,10,2.9332E-05,10
fwb,91,0.000291157,0,2.66655E-06,91
FWP,0,3.16475E-06,611,0.001631926,611
fwpnpt,0,3.16475E-06,24,6.66636E-05,24
FWPthailand,0,3.16475E-06,266,0.000711968,266
FWPthailandBad,0,3.16475E-06,17,4.79978E-05,17
FXwMHAv,0,3.16475E-06,15,4.26647E-05,15
g,187,0.000594972,102,0.000274654,289
Ga,10,3.48122E-05,0,2.66655E-06,10
gbYWwG,15,5.0636E-05,0,2.66655E-06,15
geckocooking,0,3.16475E-06,15,4.26647E-05,15
GeeBaBy,18,6.01302E-05,0,2.66655E-06,18
Get,0,3.16475E-06,14,3.99982E-05,14
gevh,0,3.16475E-06,17,4.79978E-05,17
gg,13,4.43065E-05,0,2.66655E-06,13
Give,13,4.43065E-05,0,2.66655E-06,13
gJ,0,3.16475E-06,22,6.13306E-05,22
GMM,15,5.0636E-05,0,2.66655E-06,15
GMMTV,21,6.96244E-05,0,2.66655E-06,21
Gold,0,3.16475E-06,24,6.66636E-05,24
Good,11,3.7977E-05,0,2.66655E-06,11
Got,498,0.001579209,11,3.19985E-05,509
GQvE,0,3.16475E-06,15,4.26647E-05,15
Grand,0,3.16475E-06,10,2.9332E-05,10
GrandStationwithNont,11,3.7977E-05,0,2.66655E-06,11
GrandStationXWinterFestival,14,4.74712E-05,0,2.66655E-06,14
grimmjow,0,3.16475E-06,25,6.93302E-05,25
Group,11,3.7977E-05,0,2.66655E-06,11
GsSvdvZUwcnq,0,3.16475E-06,27,7.46633E-05,27
gt,0,3.16475E-06,47,0.000127994,47
gTE,0,3.16475E-06,10,2.9332E-05,10
gtjOcXr,0,3.16475E-06,17,4.79978E-05,17
Gulf,13,4.43065E-05,0,2.66655E-06,13
gulfkanawut,83,0.000265839,0,2.66655E-06,83
GWVs,0,3.16475E-06,12,3.46651E-05,12
gxxod,15,5.0636E-05,0,2.66655E-06,15
GY,0,3.16475E-06,19,5.33309E-05,19
H,155,0.000493701,147,0.000394649,302
Happy,33,0.000107601,0,2.66655E-06,33
HappyBirthdayJin,16,5.38007E-05,0,2.66655E-06,16
HappyGulfDay,17,5.69655E-05,0,2.66655E-06,17
HAPPYJINDAY,19,6.32949E-05,0,2.66655E-06,19
happyKANAWUTday,45,0.000145578,0,2.66655E-06,45
happyKNWday,40,0.000129755,0,2.66655E-06,40
have,14,4.74712E-05,0,2.66655E-06,14
HBD,32,0.000104437,0,2.66655E-06,32
HD,22,7.27892E-05,0,2.66655E-06,22
he,12,4.11417E-05,0,2.66655E-06,12
hengsuaycountry,0,3.16475E-06,25,6.93302E-05,25
Hero,0,3.16475E-06,10,2.9332E-05,10
hG,0,3.16475E-06,16,4.53313E-05,16
hH,0,3.16475E-06,13,3.73316E-05,13
hi,13,4.43065E-05,22,6.13306E-05,35
HIMuwuy,0,3.16475E-06,11,3.19985E-05,11
Hirunkit,11,3.7977E-05,0,2.66655E-06,11
his,11,3.7977E-05,0,2.66655E-06,11
hllod,0,3.16475E-06,11,3.19985E-05,11
hm,0,3.16475E-06,19,5.33309E-05,19
Home,19,6.32949E-05,0,2.66655E-06,19
Hot,12,4.11417E-05,0,2.66655E-06,12
Hotline,0,3.16475E-06,10,2.9332E-05,10
house,15,5.0636E-05,18,5.06644E-05,33
HowtoPerfect,12,4.11417E-05,0,2.66655E-06,12
hp,10,3.48122E-05,14,3.99982E-05,24
hQ,12,4.11417E-05,0,2.66655E-06,12
hRTeTAf,0,3.16475E-06,17,4.79978E-05,17
HS,0,3.16475E-06,11,3.19985E-05,11
Ht,0,3.16475E-06,35,9.59956E-05,35
htt,0,3.16475E-06,48,0.000130661,48
http,0,3.16475E-06,73,0.000197324,73
https,8298,0.026264237,5157,0.013754043,13455
HV,0,3.16475E-06,11,3.19985E-05,11
hX,13,4.43065E-05,0,2.66655E-06,13
Hyunjin,0,3.16475E-06,33,9.06626E-05,33
i,288,0.000914612,141,0.00037865,429
iamToot,0,3.16475E-06,23,6.39971E-05,23
IC,13,4.43065E-05,0,2.66655E-06,13
id,137,0.000436735,14,3.99982E-05,151
IDOLEXCHANGExBKC,32,0.000104437,0,2.66655E-06,32
iE,15,5.0636E-05,0,2.66655E-06,15
If,20,6.64597E-05,0,2.66655E-06,20
IG,42,0.000136084,0,2.66655E-06,42
IGOT,58,0.00018672,0,2.66655E-06,58
ikea,10,3.48122E-05,0,2.66655E-06,10
iLawclub,0,3.16475E-06,113,0.000303986,113
iLawFX,0,3.16475E-06,11,3.19985E-05,11
Im,13,4.43065E-05,0,2.66655E-06,13
in,80,0.000256345,33,9.06626E-05,113
INamKaa,0,3.16475E-06,33,9.06626E-05,33
INFANTRY,0,3.16475E-06,105,0.000282654,105
INFDIV,0,3.16475E-06,17,4.79978E-05,17
inside,11,3.7977E-05,0,2.66655E-06,11
IO,15,5.0636E-05,44,0.000119995,59
iPhone,37,0.00012026,0,2.66655E-06,37
iQIYI,10,3.48122E-05,0,2.66655E-06,10
IrPjo,0,3.16475E-06,19,5.33309E-05,19
is,37,0.00012026,16,4.53313E-05,53
IsaanSopha,0,3.16475E-06,10,2.9332E-05,10
issarar,0,3.16475E-06,24,6.66636E-05,24
It,16,5.38007E-05,19,5.33309E-05,35
IV,13,4.43065E-05,0,2.66655E-06,13
iVdVeJaOOI,0,3.16475E-06,29,7.99964E-05,29
iy,0,3.16475E-06,40,0.000109328,40
J,148,0.000471547,121,0.000325319,269
JacksonWang,16,5.38007E-05,0,2.66655E-06,16
Jaebeom,13,4.43065E-05,0,2.66655E-06,13
JB,12,4.11417E-05,0,2.66655E-06,12
je,15,5.0636E-05,0,2.66655E-06,15
JHLS,0,3.16475E-06,19,5.33309E-05,19
JHoungsub,0,3.16475E-06,17,4.79978E-05,17
JIN,20,6.64597E-05,0,2.66655E-06,20
Jinyoung,14,4.74712E-05,0,2.66655E-06,14
JLI,0,3.16475E-06,10,2.9332E-05,10
JM,0,3.16475E-06,33,9.06626E-05,33
johnwinyu,0,3.16475E-06,37,0.000101329,37
jomjai,0,3.16475E-06,20,5.59975E-05,20
jr,13,4.43065E-05,0,2.66655E-06,13
JrSOoVtvy,0,3.16475E-06,18,5.06644E-05,18
js,16,5.38007E-05,17,4.79978E-05,33
Jtefj,0,3.16475E-06,11,3.19985E-05,11
JuahuaHeadline,0,3.16475E-06,324,0.000866627,324
juearch,17,5.69655E-05,0,2.66655E-06,17
Just,17,5.69655E-05,0,2.66655E-06,17
JVXx,0,3.16475E-06,11,3.19985E-05,11
K,217,0.000689915,131,0.000351984,348
ka,16,5.38007E-05,22,6.13306E-05,38
KA-,0,3.16475E-06,22,6.13306E-05,22
kandainthai,0,3.16475E-06,26,7.19967E-05,26
kanphak,0,3.16475E-06,10,2.9332E-05,10
kapookdotcom,0,3.16475E-06,10,2.9332E-05,10
kasemsanmeethip,0,3.16475E-06,44,0.000119995,44
katchata,0,3.16475E-06,47,0.000127994,47
katsuraxnosora,0,3.16475E-06,12,3.46651E-05,12
KDPPE,27,8.86129E-05,0,2.66655E-06,27
kE,0,3.16475E-06,13,3.73316E-05,13
Kea,0,3.16475E-06,17,4.79978E-05,17
KemAndWoodyshow,21,6.96244E-05,0,2.66655E-06,21
Kg,0,3.16475E-06,18,5.06644E-05,18
KH,12,4.11417E-05,0,2.66655E-06,12
KhaosodEnglish,0,3.16475E-06,26,7.19967E-05,26
khunpreut,0,3.16475E-06,13,3.73316E-05,13
kick,0,3.16475E-06,41,0.000111995,41
KiimMon,11,3.7977E-05,0,2.66655E-06,11
king,25,8.22834E-05,20,5.59975E-05,45
KingPowerOnline,11,3.7977E-05,0,2.66655E-06,11
kk,27,8.86129E-05,0,2.66655E-06,27
klaikong,0,3.16475E-06,45,0.000122661,45
Kom,0,3.16475E-06,30,8.26629E-05,30
konjing,0,3.16475E-06,20,5.59975E-05,20
kovitw,0,3.16475E-06,68,0.000183992,68
KP,0,3.16475E-06,12,3.46651E-05,12
KRf,0,3.16475E-06,16,4.53313E-05,16
KristPerawat,40,0.000129755,0,2.66655E-06,40
kristtps,10,3.48122E-05,0,2.66655E-06,10
KT,10,3.48122E-05,32,8.7996E-05,42
ktnewsonline,0,3.16475E-06,55,0.000149327,55
Ku,0,3.16475E-06,16,4.53313E-05,16
Kunthida,0,3.16475E-06,63,0.000170659,63
kZ,0,3.16475E-06,31,8.53295E-05,31
l,165,0.000525348,109,0.00029332,274
la,14,4.74712E-05,0,2.66655E-06,14
Larn,0,3.16475E-06,13,3.73316E-05,13
LAST,16,5.38007E-05,0,2.66655E-06,16
LastIFound,0,3.16475E-06,11,3.19985E-05,11
LastPiece,77,0.00024685,0,2.66655E-06,77
ld,16,5.38007E-05,0,2.66655E-06,16
lee,13,4.43065E-05,0,2.66655E-06,13
Let,0,3.16475E-06,13,3.73316E-05,13
LGinlove,0,3.16475E-06,18,5.06644E-05,18
LhxwPwUc,0,3.16475E-06,11,3.19985E-05,11
life,10,3.48122E-05,0,2.66655E-06,10
Like,0,3.16475E-06,12,3.46651E-05,12
Line,136,0.00043357,0,2.66655E-06,136
LINETODAY,0,3.16475E-06,15,4.26647E-05,15
LISA,13,4.43065E-05,0,2.66655E-06,13
live,23,7.59539E-05,29,7.99964E-05,52
Lixian,11,3.7977E-05,0,2.66655E-06,11
LJ,10,3.48122E-05,0,2.66655E-06,10
ll,21,6.96244E-05,0,2.66655E-06,21
Lm,10,3.48122E-05,0,2.66655E-06,10
loong,13,4.43065E-05,0,2.66655E-06,13
love,30,9.81072E-05,22,6.13306E-05,52
lovegenprayut,0,3.16475E-06,14,3.99982E-05,14
Lovely,0,3.16475E-06,35,9.59956E-05,35
lS,11,3.7977E-05,0,2.66655E-06,11
lT,0,3.16475E-06,14,3.99982E-05,14
Lucky,0,3.16475E-06,25,6.93302E-05,25
luek,0,3.16475E-06,30,8.26629E-05,30
lUvpvo,0,3.16475E-06,17,4.79978E-05,17
Lw,10,3.48122E-05,12,3.46651E-05,22
Lyn,13,4.43065E-05,0,2.66655E-06,13
LyVqwEhqm,0,3.16475E-06,10,2.9332E-05,10
M,238,0.000756375,132,0.000354651,370
MA,0,3.16475E-06,11,3.19985E-05,11
MaisonWanvipa,0,3.16475E-06,64,0.000173325,64
MAMA,36,0.000117096,0,2.66655E-06,36
MAMAVOTE,18,6.01302E-05,0,2.66655E-06,18
mangpowing,15,5.0636E-05,0,2.66655E-06,15
Market,20,6.64597E-05,0,2.66655E-06,20
MatichonOnline,22,7.27892E-05,253,0.000677303,275
MatichonTV,0,3.16475E-06,41,0.000111995,41
Maya,15,5.0636E-05,0,2.66655E-06,15
MC,0,3.16475E-06,62,0.000167992,62
mcot,0,3.16475E-06,10,2.9332E-05,10
MD,11,3.7977E-05,0,2.66655E-06,11
MDB,0,3.16475E-06,13,3.73316E-05,13
me,35,0.000113931,0,2.66655E-06,35
Melon,16,5.38007E-05,0,2.66655E-06,16
mew,10,3.48122E-05,0,2.66655E-06,10
Mewlions,16,5.38007E-05,0,2.66655E-06,16
MewSuppasit,32,0.000104437,0,2.66655E-06,32
mGK,0,3.16475E-06,41,0.000111995,41
MGROnlineLive,0,3.16475E-06,37,0.000101329,37
mI,0,3.16475E-06,48,0.000130661,48
MI-,0,3.16475E-06,24,6.66636E-05,24
MileswDM,10,3.48122E-05,0,2.66655E-06,10
MillennialsChoice,72,0.000231027,0,2.66655E-06,72
MintMagTH,12,4.11417E-05,0,2.66655E-06,12
MINTxMILLENNIALSCHOICE,14,4.74712E-05,0,2.66655E-06,14
MisterHeartz,0,3.16475E-06,12,3.46651E-05,12
mj,10,3.48122E-05,0,2.66655E-06,10
MK,12,4.11417E-05,0,2.66655E-06,12
ml,12,4.11417E-05,0,2.66655E-06,12
mm,12,4.11417E-05,0,2.66655E-06,12
MMA,36,0.000117096,0,2.66655E-06,36
MnetMAMA,11,3.7977E-05,0,2.66655E-06,11
mo,10,3.48122E-05,0,2.66655E-06,10
mongkhonaiam,0,3.16475E-06,19,5.33309E-05,19
moph,0,3.16475E-06,18,5.06644E-05,18
MorningNewsTV,0,3.16475E-06,60,0.000162659,60
MOU,0,3.16475E-06,14,3.99982E-05,14
mousey,0,3.16475E-06,31,8.53295E-05,31
mR,19,6.32949E-05,15,4.26647E-05,34
MRT,10,3.48122E-05,0,2.66655E-06,10
MT,14,4.74712E-05,0,2.66655E-06,14
mthai,0,3.16475E-06,40,0.000109328,40
Music,15,5.0636E-05,0,2.66655E-06,15
MusicBank,48,0.000155073,0,2.66655E-06,48
MV,17,5.69655E-05,0,2.66655E-06,17
MVDeepQuotes,0,3.16475E-06,12,3.46651E-05,12
MY,33,0.000107601,24,6.66636E-05,57
myforeversunshine,14,4.74712E-05,0,2.66655E-06,14
mylovermyheart,19,6.32949E-05,0,2.66655E-06,19
mzeed,12,4.11417E-05,0,2.66655E-06,12
N,182,0.000579149,90,0.000242656,272
na,16,5.38007E-05,0,2.66655E-06,16
naewna,0,3.16475E-06,13,3.73316E-05,13
nam,14,4.74712E-05,0,2.66655E-06,14
Nan,11,3.7977E-05,0,2.66655E-06,11
Nanakau,10,3.48122E-05,0,2.66655E-06,10
narathon,0,3.16475E-06,18,5.06644E-05,18
NationTV,0,3.16475E-06,71,0.000191991,71
nationweekend,0,3.16475E-06,16,4.53313E-05,16
nayouung,0,3.16475E-06,16,4.53313E-05,16
nCoV,0,3.16475E-06,34,9.33291E-05,34
NCT,42,0.000136084,0,2.66655E-06,42
nd,10,3.48122E-05,0,2.66655E-06,10
netflixth,0,3.16475E-06,10,2.9332E-05,10
new,20,6.64597E-05,45,0.000122661,65
news,0,3.16475E-06,2020,0.005389089,2020
newtv,0,3.16475E-06,38,0.000103995,38
NGAqkJq,0,3.16475E-06,18,5.06644E-05,18
NGO,0,3.16475E-06,10,2.9332E-05,10
Ni,16,5.38007E-05,0,2.66655E-06,16
Nichada,0,3.16475E-06,51,0.00013866,51
NK,10,3.48122E-05,0,2.66655E-06,10
NLYWDi,0,3.16475E-06,74,0.000199991,74
nnanews,0,3.16475E-06,28,7.73298E-05,28
No,19,6.32949E-05,0,2.66655E-06,19
nong,19,6.32949E-05,0,2.66655E-06,19
Nongnatty,21,6.96244E-05,0,2.66655E-06,21
nontfam,19,6.32949E-05,0,2.66655E-06,19
NONTTANONT,51,0.000164567,0,2.66655E-06,51
np,14,4.74712E-05,0,2.66655E-06,14
nPerf,0,3.16475E-06,11,3.19985E-05,11
Nu,0,3.16475E-06,10,2.9332E-05,10
nuling,0,3.16475E-06,37,0.000101329,37
nuttha,0,3.16475E-06,34,9.33291E-05,34
Nx,0,3.16475E-06,54,0.00014666,54
o,144,0.000458888,160,0.000429314,304
of,74,0.000237356,47,0.000127994,121
Off,0,3.16475E-06,40,0.000109328,40
Offchainon,0,3.16475E-06,10,2.9332E-05,10
Official,133,0.000424076,25,6.93302E-05,158
Oh,11,3.7977E-05,0,2.66655E-06,11
oHA,0,3.16475E-06,28,7.73298E-05,28
oHbczn,0,3.16475E-06,10,2.9332E-05,10
OK,27,8.86129E-05,56,0.000151993,83
on,90,0.000287992,31,8.53295E-05,121
onaridamg,11,3.7977E-05,0,2.66655E-06,11
one,20,6.64597E-05,0,2.66655E-06,20
onenews,0,3.16475E-06,10,2.9332E-05,10
ongpadipat,0,3.16475E-06,11,3.19985E-05,11
OnMyojiMJ,13,4.43065E-05,0,2.66655E-06,13
oPA,0,3.16475E-06,27,7.46633E-05,27
Open,0,3.16475E-06,18,5.06644E-05,18
or,28,9.17777E-05,10,2.9332E-05,38
orange,0,3.16475E-06,41,0.000111995,41
Os,0,3.16475E-06,10,2.9332E-05,10
OU,10,3.48122E-05,0,2.66655E-06,10
out,11,3.7977E-05,0,2.66655E-06,11
p,208,0.000661432,89,0.000239989,297
Pachachoncyber,0,3.16475E-06,10,2.9332E-05,10
PaddyPure,0,3.16475E-06,28,7.73298E-05,28
pakornwut,0,3.16475E-06,59,0.000159993,59
Pannika,0,3.16475E-06,171,0.000458646,171
PantiwaCat,0,3.16475E-06,21,5.8664E-05,21
Parasite,0,3.16475E-06,10,2.9332E-05,10
paritchi,0,3.16475E-06,35,9.59956E-05,35
Park,15,5.0636E-05,0,2.66655E-06,15
parry,12,4.11417E-05,0,2.66655E-06,12
part,0,3.16475E-06,18,5.06644E-05,18
Pattaya,13,4.43065E-05,0,2.66655E-06,13
PaXN,0,3.16475E-06,38,0.000103995,38
PEA,0,3.16475E-06,92,0.000247989,92
peach,0,3.16475E-06,41,0.000111995,41
peakpeemapol,11,3.7977E-05,0,2.66655E-06,11
peat,0,3.16475E-06,47,0.000127994,47
PeckPaLitChoke,68,0.000218368,0,2.66655E-06,68
PepsixWongnaiatUDTOWN,57,0.000183555,0,2.66655E-06,57
perthppe,11,3.7977E-05,0,2.66655E-06,11
PerthTanapon,17,5.69655E-05,0,2.66655E-06,17
Ph,10,3.48122E-05,0,2.66655E-06,10
Phongsaphat,10,3.48122E-05,0,2.66655E-06,10
photo,24,7.91187E-05,0,2.66655E-06,24
phuket,37,0.00012026,0,2.66655E-06,37
Phyme,0,3.16475E-06,22,6.13306E-05,22
Pi,12,4.11417E-05,0,2.66655E-06,12
Pichailive,0,3.16475E-06,18,5.06644E-05,18
PIECE,19,6.32949E-05,0,2.66655E-06,19
Pimzilee,12,4.11417E-05,0,2.66655E-06,12
Pita,0,3.16475E-06,18,5.06644E-05,18
Piyabutr,0,3.16475E-06,174,0.000466646,174
pizad,0,3.16475E-06,57,0.00015466,57
play,0,3.16475E-06,14,3.99982E-05,14
Pli,0,3.16475E-06,11,3.19985E-05,11
pluchanat,0,3.16475E-06,10,2.9332E-05,10
pm,21,6.96244E-05,153,0.000410648,174
PMDUThailand,0,3.16475E-06,16,4.53313E-05,16
PMOC,0,3.16475E-06,10,2.9332E-05,10
political,10,3.48122E-05,346,0.000925291,356
pon,0,3.16475E-06,11,3.19985E-05,11
Pongz,0,3.16475E-06,28,7.73298E-05,28
pookem,0,3.16475E-06,133,0.000357317,133
posted,15,5.0636E-05,0,2.66655E-06,15
posttoday,0,3.16475E-06,73,0.000197324,73
Power,21,6.96244E-05,0,2.66655E-06,21
pp,12,4.11417E-05,0,2.66655E-06,12
ppptity,12,4.11417E-05,0,2.66655E-06,12
PPRP,0,3.16475E-06,78,0.000210657,78
PPTVHD,0,3.16475E-06,135,0.00036265,135
PPTVNews,0,3.16475E-06,34,9.33291E-05,34
pr,13,4.43065E-05,2132,0.005687742,2145
prachatai,0,3.16475E-06,27,7.46633E-05,27
pran,0,3.16475E-06,25,6.93302E-05,25
prasitchai,0,3.16475E-06,11,3.19985E-05,11
PrayForKorat,0,3.16475E-06,22,6.13306E-05,22
prayutofficial,0,3.16475E-06,347,0.000927958,347
Pro,15,5.0636E-05,0,2.66655E-06,15
Procession,0,3.16475E-06,14,3.99982E-05,14
pruetthigon,0,3.16475E-06,19,5.33309E-05,19
pruk,12,4.11417E-05,0,2.66655E-06,12
pT,10,3.48122E-05,11,3.19985E-05,21
Puppylo,14,4.74712E-05,0,2.66655E-06,14
pursue,0,3.16475E-06,30,8.26629E-05,30
pzdWIHg,0,3.16475E-06,37,0.000101329,37
q,172,0.000547501,196,0.00052531,368
QdHUEEmbdmwLxdF,0,3.16475E-06,23,6.39971E-05,23
QdxT,0,3.16475E-06,16,4.53313E-05,16
qJ,0,3.16475E-06,20,5.59975E-05,20
qNCaOY,0,3.16475E-06,39,0.000106662,39
Qruq,0,3.16475E-06,74,0.000199991,74
Queen,0,3.16475E-06,12,3.46651E-05,12
r,171,0.000544337,126,0.000338651,297
radio,16,5.38007E-05,16,4.53313E-05,32
rakthai,0,3.16475E-06,28,7.73298E-05,28
Rang,0,3.16475E-06,23,6.39971E-05,23
rd,12,4.11417E-05,0,2.66655E-06,12
RDF,0,3.16475E-06,16,4.53313E-05,16
rdI,0,3.16475E-06,13,3.73316E-05,13
real,10,3.48122E-05,0,2.66655E-06,10
realMaxzTirayut,0,3.16475E-06,23,6.39971E-05,23
RedBuffaloFre,0,3.16475E-06,49,0.000133327,49
Renrael,0,3.16475E-06,12,3.46651E-05,12
Rerun,46,0.000148743,0,2.66655E-06,46
RESONANCE,27,8.86129E-05,0,2.66655E-06,27
Resort,10,3.48122E-05,0,2.66655E-06,10
reviewchiangmai,16,5.38007E-05,0,2.66655E-06,16
ReviewThailand,14,4.74712E-05,0,2.66655E-06,14
REXTChKueD,0,3.16475E-06,21,5.8664E-05,21
RM,13,4.43065E-05,0,2.66655E-06,13
Rorscha,0,3.16475E-06,202,0.000541309,202
Royal,0,3.16475E-06,24,6.66636E-05,24
RoyalThaiArmy,0,3.16475E-06,45,0.000122661,45
RT,19,6.32949E-05,11207,0.029886645,11226
RTA,0,3.16475E-06,71,0.000191991,71
rukyimfon,13,4.43065E-05,0,2.66655E-06,13
RUptNhRk,0,3.16475E-06,74,0.000199991,74
rx,12,4.11417E-05,0,2.66655E-06,12
s,228,0.000724727,154,0.000413315,382
saeplay,0,3.16475E-06,44,0.000119995,44
sagFdDIkgu,0,3.16475E-06,11,3.19985E-05,11
Saint,11,3.7977E-05,0,2.66655E-06,11
saliminyourarea,0,3.16475E-06,45,0.000122661,45
Saturn,13,4.43065E-05,0,2.66655E-06,13
save,0,3.16475E-06,43,0.000117328,43
Savekorat,0,3.16475E-06,42,0.000114661,42
savesaisawat,12,4.11417E-05,0,2.66655E-06,12
sBhlwICc,0,3.16475E-06,13,3.73316E-05,13
seawonn,0,3.16475E-06,16,4.53313E-05,16
sereepisuth,0,3.16475E-06,13,3.73316E-05,13
set,25,8.22834E-05,0,2.66655E-06,25
sex,14,4.74712E-05,0,2.66655E-06,14
Sexy,10,3.48122E-05,0,2.66655E-06,10
Shop,14,4.74712E-05,0,2.66655E-06,14
ShopeeTH,12,4.11417E-05,0,2.66655E-06,12
show,39,0.00012659,0,2.66655E-06,39
shutup,0,3.16475E-06,15,4.26647E-05,15
siam,14,4.74712E-05,90,0.000242656,104
sIAQVwHSmuDvJBpBe,0,3.16475E-06,10,2.9332E-05,10
siharatdecho,0,3.16475E-06,20,5.59975E-05,20
Silom,0,3.16475E-06,11,3.19985E-05,11
SimsetthixMPP,19,6.32949E-05,0,2.66655E-06,19
sinchaichao,0,3.16475E-06,75,0.000202657,75
SingtoPrachaya,15,5.0636E-05,0,2.66655E-06,15
Sirawith,0,3.16475E-06,19,5.33309E-05,19
sirotek,0,3.16475E-06,20,5.59975E-05,20
sj,10,3.48122E-05,0,2.66655E-06,10
sK,10,3.48122E-05,0,2.66655E-06,10
SkDoRkOag,0,3.16475E-06,22,6.13306E-05,22
Skinship,12,4.11417E-05,0,2.66655E-06,12
SkyTrain,0,3.16475E-06,59,0.000159993,59
sl,114,0.000363946,0,2.66655E-06,114
slvava,13,4.43065E-05,0,2.66655E-06,13
SM,18,6.01302E-05,0,2.66655E-06,18
SmartmanSmartsoldier,0,3.16475E-06,15,4.26647E-05,15
SmartSoldiersStrongArmyTP,0,3.16475E-06,15,4.26647E-05,15
SMARTSSArmy,0,3.16475E-06,112,0.00030132,112
Smile,12,4.11417E-05,0,2.66655E-06,12
snowballpower,11,3.7977E-05,0,2.66655E-06,11
so,30,9.81072E-05,11,3.19985E-05,41
Soldiers,0,3.16475E-06,10,2.9332E-05,10
som,10,3.48122E-05,0,2.66655E-06,10
Soon,0,3.16475E-06,13,3.73316E-05,13
sorkorlao,0,3.16475E-06,11,3.19985E-05,11
sosatseoulsayxohmfluke,29,9.49424E-05,0,2.66655E-06,29
SotYTm,0,3.16475E-06,33,9.06626E-05,33
SpringNews,0,3.16475E-06,403,0.001077284,403
ss,21,6.96244E-05,0,2.66655E-06,21
ssj,0,3.16475E-06,32,8.7996E-05,32
SSynicall,0,3.16475E-06,120,0.000322652,120
St,0,3.16475E-06,791,0.002111904,791
Stikaluk,0,3.16475E-06,57,0.00015466,57
Stone,0,3.16475E-06,16,4.53313E-05,16
Stop,0,3.16475E-06,21,5.8664E-05,21
SU,0,3.16475E-06,14,3.99982E-05,14
sudaratofficial,0,3.16475E-06,19,5.33309E-05,19
sunak,0,3.16475E-06,15,4.26647E-05,15
sup,11,3.7977E-05,0,2.66655E-06,11
Supanut,25,8.22834E-05,0,2.66655E-06,25
sura,0,3.16475E-06,42,0.000114661,42
suthichai,0,3.16475E-06,26,7.19967E-05,26
Suthida,0,3.16475E-06,10,2.9332E-05,10
SV,32,0.000104437,0,2.66655E-06,32
SW,11,3.7977E-05,0,2.66655E-06,11
t,8489,0.026868704,5047,0.013460723,13536
Tai,11,3.7977E-05,0,2.66655E-06,11
Talk,0,3.16475E-06,14,3.99982E-05,14
tanawatofficial,0,3.16475E-06,170,0.000455979,170
tanont,55,0.000177226,0,2.66655E-06,55
TanwarinS,0,3.16475E-06,56,0.000151993,56
taopiphop,0,3.16475E-06,40,0.000109328,40
Tawan,39,0.00012659,0,2.66655E-06,39
taweechaibest,0,3.16475E-06,27,7.46633E-05,27
Te,0,3.16475E-06,37,0.000101329,37
teabhoky,0,3.16475E-06,174,0.000466646,174
Teerapol,0,3.16475E-06,14,3.99982E-05,14
TEeThanapon,10,3.48122E-05,0,2.66655E-06,10
Tel,15,5.0636E-05,0,2.66655E-06,15
Tenn,0,3.16475E-06,27,7.46633E-05,27
Terminal,0,3.16475E-06,16,4.53313E-05,16
Test,0,3.16475E-06,22,6.13306E-05,22
Tf,0,3.16475E-06,17,4.79978E-05,17
th,44,0.000142414,90,0.000242656,134
thai,0,3.16475E-06,37,0.000101329,37
thaiarmyletter,0,3.16475E-06,151,0.000405315,151
ThaiCovidCenter,0,3.16475E-06,37,0.000101329,37
thaigov,0,3.16475E-06,10,2.9332E-05,10
Thailand,99,0.000316475,77,0.000207991,176
ThaiPBS,0,3.16475E-06,504,0.001346606,504
ThaiPBSNews,0,3.16475E-06,66,0.000178659,66
thaipost,0,3.16475E-06,11,3.19985E-05,11
Thairath,0,3.16475E-06,239,0.000639971,239
ThaiRoyalFamily,0,3.16475E-06,12,3.46651E-05,12
thanaaer,0,3.16475E-06,17,4.79978E-05,17
Thanathorn,0,3.16475E-06,127,0.000341318,127
THarmharm,0,3.16475E-06,14,3.99982E-05,14
that,13,4.43065E-05,0,2.66655E-06,13
the,118,0.000376605,115,0.000309319,233
TheCatCoby,0,3.16475E-06,20,5.59975E-05,20
TheGoldenSong,35,0.000113931,0,2.66655E-06,35
TheMallLifeStorexYinWar,10,3.48122E-05,0,2.66655E-06,10
thematterco,0,3.16475E-06,36,9.86622E-05,36
TheMettad,0,3.16475E-06,16,4.53313E-05,16
TheNortheastInternationalMotorShowKorat,11,3.7977E-05,0,2.66655E-06,11
thereportersth,0,3.16475E-06,15,4.26647E-05,15
theseashore,0,3.16475E-06,15,4.26647E-05,15
TheStandardPOP,0,3.16475E-06,37,0.000101329,37
thestandardth,0,3.16475E-06,162,0.000434647,162
this,17,5.69655E-05,0,2.66655E-06,17
TiaInw,0,3.16475E-06,23,6.39971E-05,23
tigeryellowlive,0,3.16475E-06,136,0.000365317,136
tiktok,10,3.48122E-05,0,2.66655E-06,10
Time,12,4.11417E-05,0,2.66655E-06,12
tintin,13,4.43065E-05,0,2.66655E-06,13
TipananOfficial,0,3.16475E-06,21,5.8664E-05,21
TJK,10,3.48122E-05,0,2.66655E-06,10
TK,14,4.74712E-05,0,2.66655E-06,14
tKrEMmYbyB,0,3.16475E-06,13,3.73316E-05,13
TLHR,0,3.16475E-06,42,0.000114661,42
TLqCWbVq,0,3.16475E-06,18,5.06644E-05,18
TN,10,3.48122E-05,0,2.66655E-06,10
TNAMCOT,0,3.16475E-06,62,0.000167992,62
To,53,0.000170896,62,0.000167992,115
Top,20,6.64597E-05,0,2.66655E-06,20
ToyotaBestDealBestDay,20,6.64597E-05,0,2.66655E-06,20
TOYOTAFestivalXMookda,14,4.74712E-05,0,2.66655E-06,14
toyubomm,0,3.16475E-06,26,7.19967E-05,26
TP,10,3.48122E-05,0,2.66655E-06,10
Tpwm,29,9.49424E-05,0,2.66655E-06,29
trafficpro,0,3.16475E-06,44,0.000119995,44
treasure,13,4.43065E-05,0,2.66655E-06,13
TRUE,11,3.7977E-05,0,2.66655E-06,11
tskcytt,0,3.16475E-06,12,3.46651E-05,12
tSnEpAdNzaskj,0,3.16475E-06,39,0.000106662,39
TT,15,5.0636E-05,0,2.66655E-06,15
tuk,15,5.0636E-05,0,2.66655E-06,15
TukBBPKT,24,7.91187E-05,0,2.66655E-06,24
TukMTPKT,18,6.01302E-05,0,2.66655E-06,18
tumsutee,10,3.48122E-05,0,2.66655E-06,10
TV,15,5.0636E-05,319,0.000853295,334
TWICE,10,3.48122E-05,0,2.66655E-06,10
twt,45,0.000145578,0,2.66655E-06,45
TY,12,4.11417E-05,0,2.66655E-06,12
tz,0,3.16475E-06,10,2.9332E-05,10
u,175,0.000556996,79,0.000213324,254
uC,11,3.7977E-05,0,2.66655E-06,11
UDTOWN,57,0.000183555,0,2.66655E-06,57
un,39,0.00012659,0,2.66655E-06,39
Unofficial,0,3.16475E-06,77,0.000207991,77
Unrulycat,0,3.16475E-06,60,0.000162659,60
up,17,5.69655E-05,0,2.66655E-06,17
UPDATE,0,3.16475E-06,15,4.26647E-05,15
US,14,4.74712E-05,0,2.66655E-06,14
ut,11,3.7977E-05,0,2.66655E-06,11
Uv,13,4.43065E-05,0,2.66655E-06,13
v,198,0.000629785,85,0.000229323,283
vb,10,3.48122E-05,13,3.73316E-05,23
VcqfBvek,0,3.16475E-06,16,4.53313E-05,16
veerayut,0,3.16475E-06,156,0.000418648,156
via,15,5.0636E-05,130,0.000349317,145
vip,28,9.17777E-05,0,2.66655E-06,28
Vj,0,3.16475E-06,43,0.000117328,43
vnomenon,0,3.16475E-06,38,0.000103995,38
Voiceonline,0,3.16475E-06,16,4.53313E-05,16
VoiceTVOfficial,0,3.16475E-06,227,0.000607972,227
vorachatMD,0,3.16475E-06,11,3.19985E-05,11
VS,14,4.74712E-05,28,7.73298E-05,42
VTalomsin,0,3.16475E-06,11,3.19985E-05,11
vY,10,3.48122E-05,0,2.66655E-06,10
vzeHWPfu,0,3.16475E-06,27,7.46633E-05,27
W,204,0.000648773,77,0.000207991,281
WarmUp,0,3.16475E-06,30,8.26629E-05,30
warriors,0,3.16475E-06,90,0.000242656,90
warwanarat,47,0.000151908,0,2.66655E-06,47
WassanaNanuam,0,3.16475E-06,921,0.002458555,921
watanamuangsook,0,3.16475E-06,11,3.19985E-05,11
watchingstar,22,7.27892E-05,0,2.66655E-06,22
WAXc,0,3.16475E-06,159,0.000426647,159
WCg,0,3.16475E-06,18,5.06644E-05,18
we,21,6.96244E-05,0,2.66655E-06,21
weeranan,0,3.16475E-06,28,7.73298E-05,28
weloverta,0,3.16475E-06,437,0.001167947,437
Westerdam,0,3.16475E-06,20,5.59975E-05,20
wethmon,0,3.16475E-06,17,4.79978E-05,17
WHO,0,3.16475E-06,20,5.59975E-05,20
win,11,3.7977E-05,0,2.66655E-06,11
winmetawin,177,0.000563325,0,2.66655E-06,177
wipa,0,3.16475E-06,24,6.66636E-05,24
wirojlak,11,3.7977E-05,137,0.000367983,148
with,10,3.48122E-05,15,4.26647E-05,25
WithPiyabutr,0,3.16475E-06,48,0.000130661,48
wJ,0,3.16475E-06,11,3.19985E-05,11
wk,10,3.48122E-05,10,2.9332E-05,20
Wm,10,3.48122E-05,23,6.39971E-05,33
wN,12,4.11417E-05,0,2.66655E-06,12
WNz,0,3.16475E-06,15,4.26647E-05,15
Woodyshow,19,6.32949E-05,0,2.66655E-06,19
Woodytalk,0,3.16475E-06,36,9.86622E-05,36
workpointnews,0,3.16475E-06,210,0.000562641,210
WorkpointShorts,0,3.16475E-06,32,8.7996E-05,32
Wuhan,0,3.16475E-06,32,8.7996E-05,32
Wy,0,3.16475E-06,21,5.8664E-05,21
X,206,0.000655103,102,0.000274654,308
XcON,0,3.16475E-06,11,3.19985E-05,11
Xk,0,3.16475E-06,13,3.73316E-05,13
XQ,0,3.16475E-06,12,3.46651E-05,12
Xr,0,3.16475E-06,11,3.19985E-05,11
xx,10,3.48122E-05,0,2.66655E-06,10
y,180,0.000572819,172,0.000461312,352
YajMzd,0,3.16475E-06,10,2.9332E-05,10
yanathicha,0,3.16475E-06,13,3.73316E-05,13
year,19,6.32949E-05,0,2.66655E-06,19
Yes,11,3.7977E-05,0,2.66655E-06,11
yg,10,3.48122E-05,0,2.66655E-06,10
YiDj,0,3.16475E-06,12,3.46651E-05,12
yingcheep,0,3.16475E-06,10,2.9332E-05,10
yinwar,14,4.74712E-05,0,2.66655E-06,14
YINWARXUDTOWN,81,0.000259509,0,2.66655E-06,81
yinyin,68,0.000218368,0,2.66655E-06,68
yJ,0,3.16475E-06,13,3.73316E-05,13
yk,0,3.16475E-06,17,4.79978E-05,17
YN,10,3.48122E-05,0,2.66655E-06,10
you,36,0.000117096,28,7.73298E-05,64
YouTube,34,0.000110766,44,0.000119995,78
Yugyeom,11,3.7977E-05,0,2.66655E-06,11
YUTA,18,6.01302E-05,0,2.66655E-06,18
yv,0,3.16475E-06,11,3.19985E-05,11
Z,166,0.000528513,65,0.000175992,231
zee,14,4.74712E-05,0,2.66655E-06,14
zenjournalist,0,3.16475E-06,10,2.9332E-05,10
zH,0,3.16475E-06,12,3.46651E-05,12
ZhentingLiu,0,3.16475E-06,12,3.46651E-05,12
ZkAxJEzMzS,0,3.16475E-06,10,2.9332E-05,10
ZkWHd,0,3.16475E-06,10,2.9332E-05,10
ZP,0,3.16475E-06,12,3.46651E-05,12
ZRgrhPVDBDZN,0,3.16475E-06,39,0.000106662,39
zSd,0,3.16475E-06,12,3.46651E-05,12
ZvRUm,0,3.16475E-06,15,4.26647E-05,15
zY,0,3.16475E-06,47,0.000127994,47
zzaauuuu,13,4.43065E-05,0,2.66655E-06,13
เ,158,0.000503195,245,0.00065597,403
เ…,0,3.16475E-06,207,0.000554642,207
"เ…""",0,3.16475E-06,139,0.000373316,139
เเค่,10,3.48122E-05,0,2.66655E-06,10
เเต่,42,0.000136084,53,0.000143993,95
เเบบ,14,4.74712E-05,30,8.26629E-05,44
เเล้ว,47,0.000151908,57,0.00015466,104
แ…,0,3.16475E-06,43,0.000117328,43
"แ…""",0,3.16475E-06,73,0.000197324,73
โ…,0,3.16475E-06,20,5.59975E-05,20
"โ…""",0,3.16475E-06,11,3.19985E-05,11
ใ…,0,3.16475E-06,48,0.000130661,48
"ใ…""",0,3.16475E-06,38,0.000103995,38
ไ…,0,3.16475E-06,43,0.000117328,43
"ไ…""",0,3.16475E-06,30,8.26629E-05,30
ก,221,0.000702574,80,0.00021599,301
ก้,75,0.000240521,0,2.66655E-06,75
ก.,56,0.000180391,79,0.000213324,135
ก…,0,3.16475E-06,50,0.000135994,50
"ก…""",0,3.16475E-06,29,7.99964E-05,29
กก,1073,0.003398939,116,0.000311986,1189
กก.,0,3.16475E-06,52,0.000141327,52
กกต.,0,3.16475E-06,49,0.000133327,49
กค,10,3.48122E-05,10,2.9332E-05,20
กง,10,3.48122E-05,0,2.66655E-06,10
กฎ,0,3.16475E-06,22,6.13306E-05,22
กฎระเบียบ,0,3.16475E-06,12,3.46651E-05,12
กฎหมาย,0,3.16475E-06,88,0.000237323,88
กฏ,0,3.16475E-06,52,0.000141327,52
กด,142,0.000452559,37,0.000101329,179
กดดัน,10,3.48122E-05,21,5.8664E-05,31
กติกา,23,7.59539E-05,25,6.93302E-05,48
กทม,111,0.000354452,12,3.46651E-05,123
กทม.,28,9.17777E-05,83,0.00022399,111
ก้น,30,9.81072E-05,0,2.66655E-06,30
กนก,0,3.16475E-06,17,4.79978E-05,17
กนิษฐา,0,3.16475E-06,12,3.46651E-05,12
กบ,0,3.16475E-06,14,3.99982E-05,14
กพ,0,3.16475E-06,12,3.46651E-05,12
กพ.,0,3.16475E-06,52,0.000141327,52
กม,14,4.74712E-05,64,0.000173325,78
กม.,0,3.16475E-06,31,8.53295E-05,31
กร,0,3.16475E-06,83,0.00022399,83
กรณี,0,3.16475E-06,139,0.000373316,139
กรม,0,3.16475E-06,251,0.00067197,251
กรมทหารราบ,0,3.16475E-06,223,0.000597306,223
กรมธนารักษ์,0,3.16475E-06,24,6.66636E-05,24
กรมหลวง,0,3.16475E-06,27,7.46633E-05,27
กรรม,15,5.0636E-05,58,0.000157326,73
กรรมการ,0,3.16475E-06,18,5.06644E-05,18
กรรมาธิการ,0,3.16475E-06,22,6.13306E-05,22
กรอก,16,5.38007E-05,0,2.66655E-06,16
กรอง,0,3.16475E-06,87,0.000234656,87
กรอบ,44,0.000142414,0,2.66655E-06,44
กระ,31,0.000101272,37,0.000101329,68
กระจก,16,5.38007E-05,0,2.66655E-06,16
กระจอก,0,3.16475E-06,11,3.19985E-05,11
กระจาย,0,3.16475E-06,33,9.06626E-05,33
กระดาษ,14,4.74712E-05,0,2.66655E-06,14
กระดึง,0,3.16475E-06,77,0.000207991,77
กระตุ้น,0,3.16475E-06,30,8.26629E-05,30
กระทบ,0,3.16475E-06,13,3.73316E-05,13
กระทรวง,0,3.16475E-06,25,6.93302E-05,25
กระทรวงกลาโหม,0,3.16475E-06,11,3.19985E-05,11
กระทรวงสาธารณสุข,0,3.16475E-06,23,6.39971E-05,23
กระทุ่ม,13,4.43065E-05,0,2.66655E-06,13
กระเทียม,0,3.16475E-06,32,8.7996E-05,32
กระแทก,13,4.43065E-05,0,2.66655E-06,13
กระบวนการ,0,3.16475E-06,34,9.33291E-05,34
กระบี่,20,6.64597E-05,0,2.66655E-06,20
กระเป๋า,61,0.000196214,13,3.73316E-05,74
กระสอบ,0,3.16475E-06,20,5.59975E-05,20
กระสุน,0,3.16475E-06,22,6.13306E-05,22
กระแส,10,3.48122E-05,81,0.000218657,91
กรัก,26,8.54482E-05,0,2.66655E-06,26
กรับ,12,4.11417E-05,0,2.66655E-06,12
กรัม,10,3.48122E-05,0,2.66655E-06,10
กร่าง,0,3.16475E-06,11,3.19985E-05,11
กราด,0,3.16475E-06,462,0.001234611,462
กร้าน,23,7.59539E-05,0,2.66655E-06,23
กราบ,48,0.000155073,17,4.79978E-05,65
กรี,24,7.91187E-05,0,2.66655E-06,24
กรี๊ด,71,0.000227862,0,2.66655E-06,71
กรุง,10,3.48122E-05,17,4.79978E-05,27
กรุงเทพ,70,0.000224697,28,7.73298E-05,98
กรุงเทพมหานคร,12,4.11417E-05,0,2.66655E-06,12
กรุงเทพฯ,11,3.7977E-05,20,5.59975E-05,31
กรุณา,0,3.16475E-06,67,0.000181325,67
กรุ๊ป,0,3.16475E-06,18,5.06644E-05,18
กรู,25,8.22834E-05,11,3.19985E-05,36
กล,0,3.16475E-06,29,7.99964E-05,29
กลม,14,4.74712E-05,0,2.66655E-06,14
กลวง,0,3.16475E-06,27,7.46633E-05,27
กล้วย,16,5.38007E-05,0,2.66655E-06,16
กล่อง,46,0.000148743,0,2.66655E-06,46
กล้อง,69,0.000221532,28,7.73298E-05,97
กลับบ้าน,80,0.000256345,51,0.00013866,131
กลับมา,107,0.000341793,48,0.000130661,155
กลัฟ,75,0.000240521,0,2.66655E-06,75
กลัว,102,0.000325969,82,0.000221323,184
กล้า,72,0.000231027,196,0.00052531,268
กลาง,35,0.000113931,67,0.000181325,102
กลางคืน,15,5.0636E-05,65,0.000175992,80
กลางดึก,0,3.16475E-06,11,3.19985E-05,11
กลางวัน,12,4.11417E-05,0,2.66655E-06,12
กล้าม,12,4.11417E-05,0,2.66655E-06,12
กล้ามเนื้อ,16,5.38007E-05,0,2.66655E-06,16
กลายเป็น,27,8.86129E-05,42,0.000114661,69
กล่าวว่า,0,3.16475E-06,13,3.73316E-05,13
กล่าวหา,0,3.16475E-06,14,3.99982E-05,14
กลาโหม,0,3.16475E-06,43,0.000117328,43
กลิ่น,30,9.81072E-05,12,3.46651E-05,42
กลุ่มชาติพันธุ์,0,3.16475E-06,16,4.53313E-05,16
กวน,34,0.000110766,0,2.66655E-06,34
ก๋วยเตี๋ยว,43,0.000139249,0,2.66655E-06,43
กวาดล้าง,0,3.16475E-06,11,3.19985E-05,11
กษัตริย์,157,0.00050003,127,0.000341318,284
กษัย,23,7.59539E-05,0,2.66655E-06,23
กห,0,3.16475E-06,13,3.73316E-05,13
กอ,11,3.7977E-05,27,7.46633E-05,38
ก่อ,14,4.74712E-05,49,0.000133327,63
ก้อ,115,0.000367111,26,7.19967E-05,141
กอ.รมน.,0,3.16475E-06,55,0.000149327,55
กอง,22,7.27892E-05,81,0.000218657,103
กองกำลัง,0,3.16475E-06,191,0.000511977,191
กองเชียร์,0,3.16475E-06,13,3.73316E-05,13
กองทัพ,0,3.16475E-06,969,0.002586549,969
กองทัพบก,0,3.16475E-06,1774,0.004733119,1774
กองทัพเรือ,0,3.16475E-06,44,0.000119995,44
กองทัพอากาศ,0,3.16475E-06,31,8.53295E-05,31
กองบัญชาการ,0,3.16475E-06,24,6.66636E-05,24
กองพล,0,3.16475E-06,148,0.000397315,148
กองพัน,0,3.16475E-06,202,0.000541309,202
กองร้อย,0,3.16475E-06,83,0.00022399,83
กอด,127,0.000405088,19,5.33309E-05,146
ก้อน,22,7.27892E-05,0,2.66655E-06,22
ก่อนที่,0,3.16475E-06,16,4.53313E-05,16
กอล์ฟ,0,3.16475E-06,17,4.79978E-05,17
ก่อสร้าง,0,3.16475E-06,17,4.79978E-05,17
ก่อเหตุ,0,3.16475E-06,37,0.000101329,37
กะ,210,0.000667762,41,0.000111995,251
กะทะ,13,4.43065E-05,0,2.66655E-06,13
กะเทย,0,3.16475E-06,13,3.73316E-05,13
กะปิ,11,3.7977E-05,0,2.66655E-06,11
กะลา,0,3.16475E-06,20,5.59975E-05,20
กัซ,22,7.27892E-05,0,2.66655E-06,22
กัญชา,0,3.16475E-06,47,0.000127994,47
กัด,23,7.59539E-05,36,9.86622E-05,59
กันแดด,11,3.7977E-05,0,2.66655E-06,11
กันต์,74,0.000237356,14,3.99982E-05,88
กันที่,13,4.43065E-05,17,4.79978E-05,30
กัมพูชา,0,3.16475E-06,18,5.06644E-05,18
กา,137,0.000436735,112,0.00030132,249
ก้า,11,3.7977E-05,0,2.66655E-06,11
กาก,0,3.16475E-06,22,6.13306E-05,22
กางเกง,35,0.000113931,0,2.66655E-06,35
กางเกงใน,12,4.11417E-05,0,2.66655E-06,12
ก้างปลา,28,9.17777E-05,0,2.66655E-06,28
กาญจนบุรี,107,0.000341793,0,2.66655E-06,107
กาด,13,4.43065E-05,0,2.66655E-06,13
ก้าน,10,3.48122E-05,0,2.66655E-06,10
กาแฟ,55,0.000177226,0,2.66655E-06,55
กาย,17,5.69655E-05,23,6.39971E-05,40
การกระทำ,15,5.0636E-05,30,8.26629E-05,45
การเกษตร,0,3.16475E-06,16,4.53313E-05,16
การแก้ปัญหา,0,3.16475E-06,11,3.19985E-05,11
การแข่งขัน,0,3.16475E-06,12,3.46651E-05,12
การควบคุม,0,3.16475E-06,11,3.19985E-05,11
การค้า,0,3.16475E-06,12,3.46651E-05,12
การงาน,10,3.48122E-05,0,2.66655E-06,10
การจราจร,0,3.16475E-06,12,3.46651E-05,12
การแจกจ่าย,0,3.16475E-06,28,7.73298E-05,28
การซ่อมแซม,0,3.16475E-06,10,2.9332E-05,10
การ์ด,45,0.000145578,0,2.66655E-06,45
การดับ,0,3.16475E-06,37,0.000101329,37
การตัดสินใจ,0,3.16475E-06,18,5.06644E-05,18
การตาม,0,3.16475E-06,11,3.19985E-05,11
การถ่ายภาพ,0,3.16475E-06,10,2.9332E-05,10
การแถลงข่าว,0,3.16475E-06,18,5.06644E-05,18
การทหาร,0,3.16475E-06,38,0.000103995,38
การท่องเที่ยว,0,3.16475E-06,20,5.59975E-05,20
การทำงาน,10,3.48122E-05,41,0.000111995,51
การนำ,0,3.16475E-06,18,5.06644E-05,18
การบริหาร,0,3.16475E-06,28,7.73298E-05,28
การปกครอง,0,3.16475E-06,21,5.8664E-05,21
การปฏิบัติ,0,3.16475E-06,35,9.59956E-05,35
การปฏิรูป,0,3.16475E-06,18,5.06644E-05,18
การประชุม,0,3.16475E-06,49,0.000133327,49
การประปาส่วนภูมิภาค,0,3.16475E-06,19,5.33309E-05,19
การป้องกัน,0,3.16475E-06,96,0.000258655,96
การปิดบัง,0,3.16475E-06,12,3.46651E-05,12
การเปลี่ยนแปลง,0,3.16475E-06,17,4.79978E-05,17
การพัฒนา,0,3.16475E-06,47,0.000127994,47
การไฟฟ้าส่วนภูมิภาค,0,3.16475E-06,40,0.000109328,40
การเมือง,12,4.11417E-05,126,0.000338651,138
การรักษา,0,3.16475E-06,17,4.79978E-05,17
การรัฐประหาร,0,3.16475E-06,20,5.59975E-05,20
การเลือกตั้ง,0,3.16475E-06,32,8.7996E-05,32
การศึกษา,27,8.86129E-05,38,0.000103995,65
การสงคราม,0,3.16475E-06,34,9.33291E-05,34
การสื่อสาร,0,3.16475E-06,11,3.19985E-05,11
การแสดง,12,4.11417E-05,22,6.13306E-05,34
การแสดงออก,0,3.16475E-06,23,6.39971E-05,23
ก้าว,28,9.17777E-05,32,8.7996E-05,60
กำ,18,6.01302E-05,62,0.000167992,80
กำกับ,0,3.16475E-06,12,3.46651E-05,12
กำจัด,0,3.16475E-06,36,9.86622E-05,36
กำชับ,0,3.16475E-06,26,7.19967E-05,26
กำนัน,0,3.16475E-06,15,4.26647E-05,15
กำแพง,14,4.74712E-05,22,6.13306E-05,36
กำแพงเพชร,22,7.27892E-05,0,2.66655E-06,22
กำลังใจ,71,0.000227862,1036,0.002765208,1107
กำลังดี,14,4.74712E-05,0,2.66655E-06,14
กิ,17,5.69655E-05,27,7.46633E-05,44
กิ๊ก,18,6.01302E-05,0,2.66655E-06,18
กิ่ง,12,4.11417E-05,0,2.66655E-06,12
กิจ,0,3.16475E-06,38,0.000103995,38
กิจกรรม,49,0.000158237,213,0.000570641,262
กิจการ,0,3.16475E-06,44,0.000119995,44
กิตติ,0,3.16475E-06,29,7.99964E-05,29
กิน,576,0.001826059,84,0.000226656,660
กินข้าว,55,0.000177226,10,2.9332E-05,65
กิโลกรัม,0,3.16475E-06,58,0.000157326,58
กิ่ว,0,3.16475E-06,13,3.73316E-05,13
กี,10,3.48122E-05,0,2.66655E-06,10
กี่,109,0.000348122,36,9.86622E-05,145
กี้,48,0.000155073,0,2.66655E-06,48
กี๊,10,3.48122E-05,0,2.66655E-06,10
กีฬา,12,4.11417E-05,43,0.000117328,55
กุ,338,0.001072849,0,2.66655E-06,338
กุก,26,8.54482E-05,0,2.66655E-06,26
กุ้ง,30,9.81072E-05,0,2.66655E-06,30
กุมภา,0,3.16475E-06,10,2.9332E-05,10
กุล,0,3.16475E-06,67,0.000181325,67
กุศล,0,3.16475E-06,13,3.73316E-05,13
กู้,14,4.74712E-05,53,0.000143993,67
กู้เงิน,0,3.16475E-06,51,0.00013866,51
เก,54,0.000174061,23,6.39971E-05,77
เก้,17,5.69655E-05,0,2.66655E-06,17
เก๋,17,5.69655E-05,0,2.66655E-06,17
เก่ง,244,0.000775363,94,0.000253322,338
เกณฑ์,0,3.16475E-06,11,3.19985E-05,11
เกณฑ์ทหาร,0,3.16475E-06,25,6.93302E-05,25
เกม,16,5.38007E-05,44,0.000119995,60
เกมส์,12,4.11417E-05,0,2.66655E-06,12
เกย์,47,0.000151908,0,2.66655E-06,47
เกร็ด,22,7.27892E-05,0,2.66655E-06,22
เกรี้ยวกราด,0,3.16475E-06,10,2.9332E-05,10
เกล้า,17,5.69655E-05,0,2.66655E-06,17
เกลียด,49,0.000158237,29,7.99964E-05,78
เกษตร,17,5.69655E-05,36,9.86622E-05,53
เกษตรกร,0,3.16475E-06,14,3.99982E-05,14
เกษม,0,3.16475E-06,24,6.66636E-05,24
เกษียณ,0,3.16475E-06,61,0.000165326,61
เกษียร,0,3.16475E-06,37,0.000101329,37
เกา,30,9.81072E-05,0,2.66655E-06,30
เก่า,58,0.00018672,22,6.13306E-05,80
เก้า,16,5.38007E-05,0,2.66655E-06,16
เกาหลี,69,0.000221532,20,5.59975E-05,89
เกาหลีใต้,0,3.16475E-06,22,6.13306E-05,22
เก้าอี้,0,3.16475E-06,13,3.73316E-05,13
เกาะ,51,0.000164567,18,5.06644E-05,69
เกาะติด,0,3.16475E-06,12,3.46651E-05,12
เกิดขึ้น,18,6.01302E-05,114,0.000306653,132
เกิดผล,0,3.16475E-06,12,3.46651E-05,12
เกิดเหตุ,0,3.16475E-06,27,7.46633E-05,27
เกินไป,43,0.000139249,17,4.79978E-05,60
เกีย,24,7.91187E-05,0,2.66655E-06,24
เกียรติ,0,3.16475E-06,61,0.000165326,61
เกียรติคุณ,0,3.16475E-06,34,9.33291E-05,34
เกี่ยว,0,3.16475E-06,33,9.06626E-05,33
แก้,62,0.000199379,64,0.000173325,126
แก้ไขปัญหา,0,3.16475E-06,117,0.000314652,117
แกง,33,0.000107601,0,2.66655E-06,33
แก๊ง,26,8.54482E-05,28,7.73298E-05,54
แก๊งค์,10,3.48122E-05,0,2.66655E-06,10
แก้ปัญหา,0,3.16475E-06,115,0.000309319,115
แก้ม,43,0.000139249,0,2.66655E-06,43
แกรนด์,14,4.74712E-05,0,2.66655E-06,14
แกล้ง,15,5.0636E-05,0,2.66655E-06,15
แก้ว,56,0.000180391,16,4.53313E-05,72
แกะ,23,7.59539E-05,0,2.66655E-06,23
โก,43,0.000139249,13,3.73316E-05,56
โก้,10,3.48122E-05,0,2.66655E-06,10
โก๋,16,5.38007E-05,0,2.66655E-06,16
โกโก้,14,4.74712E-05,0,2.66655E-06,14
โกง,14,4.74712E-05,72,0.000194658,86
โกรธ,19,6.32949E-05,20,5.59975E-05,39
โกลด์,0,3.16475E-06,31,8.53295E-05,31
โกหก,14,4.74712E-05,32,8.7996E-05,46
ใกล้เคียง,15,5.0636E-05,13,3.73316E-05,28
ใกล้ชิด,0,3.16475E-06,21,5.8664E-05,21
ไก่,34,0.000110766,10,2.9332E-05,44
ข,22,7.27892E-05,0,2.66655E-06,22
ข…,0,3.16475E-06,17,4.79978E-05,17
ขน,33,0.000107601,24,6.66636E-05,57
ขนม,80,0.000256345,0,2.66655E-06,80
ขนมหวาน,10,3.48122E-05,0,2.66655E-06,10
ขนย้าย,0,3.16475E-06,37,0.000101329,37
ขนส่ง,0,3.16475E-06,25,6.93302E-05,25
ขนาด,172,0.000547501,210,0.000562641,382
ขนาดเล็ก,0,3.16475E-06,26,7.19967E-05,26
ขนาดใหญ่,0,3.16475E-06,12,3.46651E-05,12
ขบวน,0,3.16475E-06,207,0.000554642,207
ขบวนการ,0,3.16475E-06,26,7.19967E-05,26
ข่มขืน,0,3.16475E-06,10,2.9332E-05,10
ขย่ม,17,5.69655E-05,0,2.66655E-06,17
ขยะ,0,3.16475E-06,36,9.86622E-05,36
ขยะสังคม,0,3.16475E-06,13,3.73316E-05,13
ขยัน,18,6.01302E-05,0,2.66655E-06,18
ขยับ,16,5.38007E-05,11,3.19985E-05,27
ขยาย,0,3.16475E-06,18,5.06644E-05,18
ขยายผล,0,3.16475E-06,19,5.33309E-05,19
ขยี้,0,3.16475E-06,14,3.99982E-05,14
ขวด,20,6.64597E-05,0,2.66655E-06,20
ขวบ,30,9.81072E-05,12,3.46651E-05,42
ขวัญ,16,5.38007E-05,51,0.00013866,67
ขวา,11,3.7977E-05,0,2.66655E-06,11
ข้อ,0,3.16475E-06,97,0.000261321,97
ข้อความ,24,7.91187E-05,20,5.59975E-05,44
ขอความร่วมมือ,0,3.16475E-06,12,3.46651E-05,12
ข้อคิด,15,5.0636E-05,0,2.66655E-06,15
ของกิน,10,3.48122E-05,0,2.66655E-06,10
ของขวัญ,57,0.000183555,25,6.93302E-05,82
ของจริง,16,5.38007E-05,0,2.66655E-06,16
ของแจก,24,7.91187E-05,0,2.66655E-06,24
ข้องใจ,0,3.16475E-06,10,2.9332E-05,10
ของดี,22,7.27892E-05,0,2.66655E-06,22
ของแถม,11,3.7977E-05,0,2.66655E-06,11
ของแท้,16,5.38007E-05,0,2.66655E-06,16
ข้อเท็จจริง,0,3.16475E-06,64,0.000173325,64
ขอโทษ,48,0.000155073,56,0.000151993,104
ขอนแก่น,276,0.000876635,48,0.000130661,324
ขอบ,63,0.000202544,0,2.66655E-06,63
ขอบคุณ,426,0.001351347,380,0.001015954,806
ขอบพระคุณ,15,5.0636E-05,0,2.66655E-06,15
ขอพร,16,5.38007E-05,0,2.66655E-06,16
ข้อมูล,19,6.32949E-05,203,0.000543975,222
ขอร้อง,16,5.38007E-05,0,2.66655E-06,16
ขอเวลา,0,3.16475E-06,15,4.26647E-05,15
ข้อเสนอ,0,3.16475E-06,17,4.79978E-05,17
ข้อหา,0,3.16475E-06,16,4.53313E-05,16
ขอให้,154,0.000490536,380,0.001015954,534
ขออนุญาต,16,5.38007E-05,11,3.19985E-05,27
ขออภัย,20,6.64597E-05,23,6.39971E-05,43
ขัดแย้ง,0,3.16475E-06,10,2.9332E-05,10
ขัตติย,0,3.16475E-06,10,2.9332E-05,10
ขั้นตอน,0,3.16475E-06,20,5.59975E-05,20
ขันธ์,10,3.48122E-05,0,2.66655E-06,10
ขับ,26,8.54482E-05,15,4.26647E-05,41
ขับเคลื่อน,0,3.16475E-06,18,5.06644E-05,18
ขับรถ,46,0.000148743,0,2.66655E-06,46
ขา,61,0.000196214,21,5.8664E-05,82
ข่า,10,3.48122E-05,0,2.66655E-06,10
ข้างนอก,15,5.0636E-05,0,2.66655E-06,15
ข้างใน,12,4.11417E-05,0,2.66655E-06,12
ข้างหน้า,13,4.43065E-05,0,2.66655E-06,13
ข้างหลัง,0,3.16475E-06,51,0.00013866,51
ขาดแคลน,0,3.16475E-06,15,4.26647E-05,15
ขาดดุล,0,3.16475E-06,10,2.9332E-05,10
ข้าพระพุทธเจ้า,11,3.7977E-05,0,2.66655E-06,11
ข้าม,36,0.000117096,26,7.19967E-05,62
ข้ามชาติ,0,3.16475E-06,14,3.99982E-05,14
ข้ามแดน,0,3.16475E-06,50,0.000135994,50
ขาย,397,0.001259569,73,0.000197324,470
ขายของ,26,8.54482E-05,0,2.66655E-06,26
ขายตัว,156,0.000496865,0,2.66655E-06,156
ขายบริการ,66,0.000212038,0,2.66655E-06,66
ข้าราชการ,0,3.16475E-06,32,8.7996E-05,32
ขาว,91,0.000291157,21,5.8664E-05,112
ข่าว,42,0.000136084,621,0.001658591,663
ข้าว,57,0.000183555,32,8.7996E-05,89
ข่าวดี,0,3.16475E-06,22,6.13306E-05,22
ข้าวต้ม,12,4.11417E-05,0,2.66655E-06,12
ข้าวเปลือก,0,3.16475E-06,10,2.9332E-05,10
ข่าวสาร,0,3.16475E-06,39,0.000106662,39
ข้าวสาร,10,3.48122E-05,0,2.66655E-06,10
ขำ,94,0.000300651,33,9.06626E-05,127
ขิม,24,7.91187E-05,0,2.66655E-06,24
ขี่,14,4.74712E-05,0,2.66655E-06,14
ขี้,84,0.000269004,16,4.53313E-05,100
ขี้เกียจ,24,7.91187E-05,0,2.66655E-06,24
ขี้ข้า,0,3.16475E-06,16,4.53313E-05,16
ขี้เหล็ก,0,3.16475E-06,17,4.79978E-05,17
ขึ้นไป,29,9.49424E-05,20,5.59975E-05,49
ขุด,0,3.16475E-06,23,6.39971E-05,23
ขุดเจาะ,0,3.16475E-06,185,0.000495978,185
ขุน,0,3.16475E-06,10,2.9332E-05,10
ขุ่น,10,3.48122E-05,0,2.66655E-06,10
ขู่,0,3.16475E-06,38,0.000103995,38
เข้,0,3.16475E-06,16,4.53313E-05,16
เข็ง,15,5.0636E-05,0,2.66655E-06,15
เขต,10,3.48122E-05,90,0.000242656,100
เขน,11,3.7977E-05,14,3.99982E-05,25
เข้ม,58,0.00018672,37,0.000101329,95
เข้มแข็ง,0,3.16475E-06,28,7.73298E-05,28
เข้มงวด,0,3.16475E-06,14,3.99982E-05,14
เขมร,0,3.16475E-06,10,2.9332E-05,10
เข้ากลุ่ม,10,3.48122E-05,0,2.66655E-06,10
เขาค้อ,15,5.0636E-05,0,2.66655E-06,15
เข้างาน,11,3.7977E-05,0,2.66655E-06,11
เข้าใจผิด,0,3.16475E-06,37,0.000101329,37
เข้าถึง,0,3.16475E-06,17,4.79978E-05,17
เข้าทาง,0,3.16475E-06,10,2.9332E-05,10
เข้าไป,60,0.00019305,82,0.000221323,142
เข้ามา,82,0.000262674,88,0.000237323,170
เข้าร่วม,10,3.48122E-05,42,0.000114661,52
เข้าเวร,0,3.16475E-06,37,0.000101329,37
เข้าสู่,0,3.16475E-06,12,3.46651E-05,12
เขาใหญ่,18,6.01302E-05,14,3.99982E-05,32
เขิน,78,0.000250015,0,2.66655E-06,78
เขิล,13,4.43065E-05,0,2.66655E-06,13
เขียม,0,3.16475E-06,12,3.46651E-05,12
เขียว,49,0.000158237,40,0.000109328,89
เขื่อน,11,3.7977E-05,0,2.66655E-06,11
แข่ง,14,4.74712E-05,0,2.66655E-06,14
แข็ง,21,6.96244E-05,17,4.79978E-05,38
แข็งแกร่ง,0,3.16475E-06,45,0.000122661,45
แข่งขัน,0,3.16475E-06,24,6.66636E-05,24
แข็งแรง,30,9.81072E-05,30,8.26629E-05,60
แขน,21,6.96244E-05,0,2.66655E-06,21
โขง,0,3.16475E-06,26,7.19967E-05,26
ไข,0,3.16475E-06,11,3.19985E-05,11
ไข่,26,8.54482E-05,0,2.66655E-06,26
ค์,17,5.69655E-05,10,2.9332E-05,27
ค,291,0.000924106,144,0.000386649,435
ค.,0,3.16475E-06,43,0.000117328,43
ค…,0,3.16475E-06,28,7.73298E-05,28
"ค…""",0,3.16475E-06,45,0.000122661,45
คค,14,4.74712E-05,0,2.66655E-06,14
คณะ,28,9.17777E-05,81,0.000218657,109
คณะกรรมการ,0,3.16475E-06,35,9.59956E-05,35
คณะทำงาน,0,3.16475E-06,12,3.46651E-05,12
คณา,10,3.48122E-05,0,2.66655E-06,10
คดี,17,5.69655E-05,214,0.000573307,231
คดีอาญา,0,3.16475E-06,13,3.73316E-05,13
คน,1690,0.005351588,1333,0.003557172,3023
คนเก่ง,42,0.000136084,0,2.66655E-06,42
คนจีน,0,3.16475E-06,13,3.73316E-05,13
คนเจ็บ,0,3.16475E-06,15,4.26647E-05,15
คนดี,43,0.000139249,65,0.000175992,108
คนเดียว,148,0.000471547,22,6.13306E-05,170
คนตาย,0,3.16475E-06,16,4.53313E-05,16
คนไทย,30,9.81072E-05,329,0.00087996,359
คนใน,28,9.17777E-05,47,0.000127994,75
ค้นพบ,0,3.16475E-06,13,3.73316E-05,13
คนฟัง,10,3.48122E-05,0,2.66655E-06,10
คนรวย,11,3.7977E-05,0,2.66655E-06,11
คนรัก,30,9.81072E-05,11,3.19985E-05,41
คนร้าย,0,3.16475E-06,118,0.000317319,118
คนรุ่นใหม่,0,3.16475E-06,32,8.7996E-05,32
คนเรา,26,8.54482E-05,62,0.000167992,88
คนละ,53,0.000170896,24,6.66636E-05,77
คนละไม้คนละมือ,0,3.16475E-06,10,2.9332E-05,10
คนสวย,22,7.27892E-05,0,2.66655E-06,22
ค้นหา,0,3.16475E-06,10,2.9332E-05,10
คนอื่น,91,0.000291157,95,0.000255988,186
คบ,32,0.000104437,0,2.66655E-06,32
คม,0,3.16475E-06,13,3.73316E-05,13
คมชัด,0,3.16475E-06,50,0.000135994,50
คมนาคม,0,3.16475E-06,19,5.33309E-05,19
ครม,0,3.16475E-06,11,3.19985E-05,11
ครม.,0,3.16475E-06,21,5.8664E-05,21
ครอง,0,3.16475E-06,10,2.9332E-05,10
ครอบครัว,63,0.000202544,363,0.000970623,426
ครอบจักรวาล,0,3.16475E-06,10,2.9332E-05,10
ครั้งแรก,30,9.81072E-05,31,8.53295E-05,61
ครั้งหน้า,12,4.11417E-05,0,2.66655E-06,12
ครับผม,91,0.000291157,13,3.73316E-05,104
ครัว,13,4.43065E-05,0,2.66655E-06,13
ครัวเรือน,0,3.16475E-06,11,3.19985E-05,11
คร่า,32,0.000104437,0,2.66655E-06,32
คราบ,14,4.74712E-05,0,2.66655E-06,14
คร้าบ,35,0.000113931,0,2.66655E-06,35
คริสต์มาส,15,5.0636E-05,0,2.66655E-06,15
ครีม,26,8.54482E-05,0,2.66655E-06,26
ครึ่ง,61,0.000196214,11,3.19985E-05,72
ครู,37,0.00012026,109,0.00029332,146
คลอ,15,5.0636E-05,10,2.9332E-05,25
คลอง,75,0.000240521,17,4.79978E-05,92
คลัง,0,3.16475E-06,81,0.000218657,81
คลั่ง,29,9.49424E-05,40,0.000109328,69
คลังแสง,0,3.16475E-06,10,2.9332E-05,10
คลาย,27,8.86129E-05,42,0.000114661,69
คลาส,13,4.43065E-05,0,2.66655E-06,13
คลิก,25,8.22834E-05,0,2.66655E-06,25
คลิป,304,0.000965248,72,0.000194658,376
คลี,22,7.27892E-05,14,3.99982E-05,36
คลี่คลาย,0,3.16475E-06,38,0.000103995,38
ควง,0,3.16475E-06,15,4.26647E-05,15
ควบคุม,0,3.16475E-06,125,0.000335985,125
ควย,215,0.000683585,22,6.13306E-05,237
ควรจะ,12,4.11417E-05,16,4.53313E-05,28
ควัน,0,3.16475E-06,29,7.99964E-05,29
ความกล้าหาญ,0,3.16475E-06,26,7.19967E-05,26
ความเข้าใจ,0,3.16475E-06,13,3.73316E-05,13
ความคิด,27,8.86129E-05,73,0.000197324,100
ความคืบหน้า,0,3.16475E-06,27,7.46633E-05,27
ความจริง,21,6.96244E-05,80,0.00021599,101
ความจำเป็น,0,3.16475E-06,27,7.46633E-05,27
ความเจริญ,0,3.16475E-06,14,3.99982E-05,14
ความช่วยเหลือ,0,3.16475E-06,12,3.46651E-05,12
ความชำนาญ,0,3.16475E-06,32,8.7996E-05,32
ความดี,18,6.01302E-05,73,0.000197324,91
ความเดือดร้อน,0,3.16475E-06,76,0.000205324,76
ความต้องการ,0,3.16475E-06,12,3.46651E-05,12
ความแตกแยก,0,3.16475E-06,23,6.39971E-05,23
ความทรงจำ,10,3.48122E-05,13,3.73316E-05,23
ความเท่าเทียม,0,3.16475E-06,14,3.99982E-05,14
ความน่ารัก,25,8.22834E-05,0,2.66655E-06,25
ความปลอดภัย,0,3.16475E-06,50,0.000135994,50
ความปลื้ม,0,3.16475E-06,11,3.19985E-05,11
ความเป็นธรรม,0,3.16475E-06,10,2.9332E-05,10
ความผิด,0,3.16475E-06,30,8.26629E-05,30
ความพร้อม,0,3.16475E-06,99,0.000266655,99
ความภูมิใจ,0,3.16475E-06,14,3.99982E-05,14
ความมั่นคง,0,3.16475E-06,60,0.000162659,60
ความยุติธรรม,0,3.16475E-06,13,3.73316E-05,13
ความร่วมมือ,0,3.16475E-06,30,8.26629E-05,30
ความรัก,108,0.000344957,43,0.000117328,151
ความรับผิดชอบ,0,3.16475E-06,25,6.93302E-05,25
ความรุนแรง,0,3.16475E-06,36,9.86622E-05,36
ความรู้,13,4.43065E-05,61,0.000165326,74
ความรู้สึก,83,0.000265839,36,9.86622E-05,119
ความลับ,10,3.48122E-05,16,4.53313E-05,26
ความวุ่นวาย,0,3.16475E-06,63,0.000170659,63
ความสงบ,0,3.16475E-06,26,7.19967E-05,26
ความสัมพันธ์,35,0.000113931,0,2.66655E-06,35
ความสามารถ,0,3.16475E-06,21,5.8664E-05,21
ความสำคัญ,0,3.16475E-06,32,8.7996E-05,32
ความสุข,85,0.000272168,48,0.000130661,133
ความสูญเสีย,0,3.16475E-06,33,9.06626E-05,33
ความเสี่ยง,0,3.16475E-06,12,3.46651E-05,12
ความเสียใจ,0,3.16475E-06,300,0.00080263,300
ความหมาย,0,3.16475E-06,11,3.19985E-05,11
ความห่วงใย,0,3.16475E-06,119,0.000319985,119
ความเห็น,0,3.16475E-06,11,3.19985E-05,11
ควาย,53,0.000170896,107,0.000287987,160
ควีน,0,3.16475E-06,14,3.99982E-05,14
คสช.,0,3.16475E-06,28,7.73298E-05,28
คอ,113,0.000360781,14,3.99982E-05,127
คอก,0,3.16475E-06,10,2.9332E-05,10
คอน,63,0.000202544,10,2.9332E-05,73
คอนโด,14,4.74712E-05,0,2.66655E-06,14
คอนเสิร์ต,20,6.64597E-05,0,2.66655E-06,20
คอบ,0,3.16475E-06,31,8.53295E-05,31
คอม,23,7.59539E-05,10,2.9332E-05,33
คอย,44,0.000142414,95,0.000255988,139
ค้ะ,16,5.38007E-05,0,2.66655E-06,16
ค๊ะ,0,3.16475E-06,14,3.99982E-05,14
คะแนน,25,8.22834E-05,30,8.26629E-05,55
คัด,0,3.16475E-06,94,0.000253322,94
คัดค้าน,0,3.16475E-06,59,0.000159993,59
คัน,33,0.000107601,21,5.8664E-05,54
คั่น,11,3.7977E-05,0,2.66655E-06,11
คับ,446,0.001414642,56,0.000151993,502
คับบ,13,4.43065E-05,0,2.66655E-06,13
คัพ,11,3.7977E-05,0,2.66655E-06,11
คัย,12,4.11417E-05,0,2.66655E-06,12
คา,39,0.00012659,11,3.19985E-05,50
ค่า,342,0.001085508,86,0.000231989,428
ค้า,29,9.49424E-05,0,2.66655E-06,29
คํา,10,3.48122E-05,0,2.66655E-06,10
ค้าง,16,5.38007E-05,0,2.66655E-06,16
ค้างคืน,11,3.7977E-05,0,2.66655E-06,11
ค่าเฉลี่ย,0,3.16475E-06,11,3.19985E-05,11
ค่าใช้จ่าย,17,5.69655E-05,0,2.66655E-06,17
คาด,11,3.7977E-05,30,8.26629E-05,41
คาดหวัง,18,6.01302E-05,0,2.66655E-06,18
ค้าน,0,3.16475E-06,13,3.73316E-05,13
ค้าบ,196,0.000623455,15,4.26647E-05,211
คาเฟ่,77,0.00024685,0,2.66655E-06,77
ค่าย,44,0.000142414,188,0.000503977,232
ค่ายทหาร,0,3.16475E-06,60,0.000162659,60
คำ่,0,3.16475E-06,10,2.9332E-05,10
ค่ำ,15,5.0636E-05,20,5.59975E-05,35
คำขวัญ,0,3.16475E-06,34,9.33291E-05,34
คำคม,12,4.11417E-05,0,2.66655E-06,12
คำตอบ,19,6.32949E-05,12,3.46651E-05,31
คำตัดสิน,0,3.16475E-06,20,5.59975E-05,20
คำถาม,13,4.43065E-05,12,3.46651E-05,25
คำนึง,0,3.16475E-06,15,4.26647E-05,15
คำนึงถึง,0,3.16475E-06,14,3.99982E-05,14
คำแนะนำ,0,3.16475E-06,65,0.000175992,65
คำบรรยาย,0,3.16475E-06,10,2.9332E-05,10
คำพูด,21,6.96244E-05,37,0.000101329,58
คำวินิจฉัย,0,3.16475E-06,36,9.86622E-05,36
คำสั่ง,0,3.16475E-06,32,8.7996E-05,32
คิดได้,11,3.7977E-05,21,5.8664E-05,32
คิดถึง,257,0.000816505,64,0.000173325,321
คิดมาก,14,4.74712E-05,0,2.66655E-06,14
คิดเห็น,0,3.16475E-06,11,3.19985E-05,11
คิว,71,0.000227862,16,4.53313E-05,87
คิ้ว,29,9.49424E-05,0,2.66655E-06,29
คึกคัก,0,3.16475E-06,13,3.73316E-05,13
คื…,0,3.16475E-06,16,4.53313E-05,16
คืน,74,0.000237356,55,0.000149327,129
คืนนี้,177,0.000563325,19,5.33309E-05,196
คืบหน้า,0,3.16475E-06,25,6.93302E-05,25
คุ,73,0.000234191,24,6.66636E-05,97
คุก,0,3.16475E-06,44,0.000119995,44
คุกคาม,0,3.16475E-06,11,3.19985E-05,11
คุณค่า,23,7.59539E-05,0,2.66655E-06,23
คุณพ่อ,31,0.000101272,0,2.66655E-06,31
คุณภาพ,23,7.59539E-05,35,9.59956E-05,58
คุณแม่,19,6.32949E-05,0,2.66655E-06,19
คุณยาย,15,5.0636E-05,0,2.66655E-06,15
คุม,27,8.86129E-05,30,8.26629E-05,57
คุ้ม,49,0.000158237,0,2.66655E-06,49
คุ้มครอง,0,3.16475E-06,15,4.26647E-05,15
คุย,235,0.00074688,46,0.000125328,281
คู,16,5.38007E-05,0,2.66655E-06,16
คู่,146,0.000465218,30,8.26629E-05,176
คูณ,16,5.38007E-05,25,6.93302E-05,41
คู่นอน,79,0.00025318,0,2.66655E-06,79
คู่มือ,0,3.16475E-06,11,3.19985E-05,11
คู่รัก,0,3.16475E-06,12,3.46651E-05,12
เค,60,0.00019305,23,6.39971E-05,83
เค้ก,46,0.000148743,0,2.66655E-06,46
เคมี,11,3.7977E-05,0,2.66655E-06,11
เครดิต,16,5.38007E-05,0,2.66655E-06,16
เคราะห์,0,3.16475E-06,14,3.99982E-05,14
เครียด,28,9.17777E-05,23,6.39971E-05,51
เครือ,25,8.22834E-05,0,2.66655E-06,25
เครือข่าย,0,3.16475E-06,29,7.99964E-05,29
เครื่อง,67,0.000215203,68,0.000183992,135
เครื่องดื่ม,16,5.38007E-05,0,2.66655E-06,16
เครื่องบิน,11,3.7977E-05,41,0.000111995,52
เครื่องแบบ,0,3.16475E-06,20,5.59975E-05,20
เครื่องมือ,0,3.16475E-06,20,5.59975E-05,20
เคลียร์,11,3.7977E-05,13,3.73316E-05,24
เคลื่อน,0,3.16475E-06,25,6.93302E-05,25
เคลื่อนที่,0,3.16475E-06,28,7.73298E-05,28
เคลื่อนย้าย,0,3.16475E-06,18,5.06644E-05,18
เคส,22,7.27892E-05,0,2.66655E-06,22
เคา,10,3.48122E-05,0,2.66655E-06,10
เค้า,452,0.001433631,126,0.000338651,578
เคารพ,0,3.16475E-06,83,0.00022399,83
เคียงข้าง,0,3.16475E-06,58,0.000157326,58
เคี้ยว,11,3.7977E-05,0,2.66655E-06,11
แค,13,4.43065E-05,0,2.66655E-06,13
แคน,10,3.48122E-05,0,2.66655E-06,10
แค้น,0,3.16475E-06,12,3.46651E-05,12
แคป,285,0.000905118,17,4.79978E-05,302
แคมเปญ,0,3.16475E-06,21,5.8664E-05,21
แคร์,31,0.000101272,0,2.66655E-06,31
โค,58,0.00018672,454,0.001213278,512
โค้ด,11,3.7977E-05,0,2.66655E-06,11
โคตร,120,0.000382934,16,4.53313E-05,136
โครง,0,3.16475E-06,31,8.53295E-05,31
โครงการ,19,6.32949E-05,223,0.000597306,242
โคราช,220,0.000699409,596,0.001591928,816
โคโรน่า,0,3.16475E-06,223,0.000597306,223
โควิด,130,0.000414582,129,0.000346651,259
ใครก็ได้,14,4.74712E-05,0,2.66655E-06,14
ไค,14,4.74712E-05,0,2.66655E-06,14
ฆ่า,15,5.0636E-05,57,0.00015466,72
ฆ่าเชื้อ,0,3.16475E-06,11,3.19985E-05,11
โฆษก,0,3.16475E-06,94,0.000253322,94
โฆษณา,13,4.43065E-05,0,2.66655E-06,13
ง,333,0.001057026,110,0.000295987,443
งก,10,3.48122E-05,14,3.99982E-05,24
งง,610,0.001933661,65,0.000175992,675
งด,21,6.96244E-05,38,0.000103995,59
งดงาม,0,3.16475E-06,54,0.00014666,54
งบ,30,9.81072E-05,47,0.000127994,77
งบประมาณ,0,3.16475E-06,56,0.000151993,56
ง่วง,44,0.000142414,0,2.66655E-06,44
งวด,12,4.11417E-05,0,2.66655E-06,12
งอ,17,5.69655E-05,0,2.66655E-06,17
ง้อ,15,5.0636E-05,0,2.66655E-06,15
งอแง,27,8.86129E-05,0,2.66655E-06,27
ง่ะ,15,5.0636E-05,0,2.66655E-06,15
งั้น,37,0.00012026,35,9.59956E-05,72
งับ,85,0.000272168,0,2.66655E-06,85
งัย,14,4.74712E-05,0,2.66655E-06,14
งา,16,5.38007E-05,0,2.66655E-06,16
ง่า,12,4.11417E-05,0,2.66655E-06,12
งาน,760,0.002408373,200,0.000535976,960
งานแต่ง,10,3.48122E-05,0,2.66655E-06,10
งานบ้าน,49,0.000158237,0,2.66655E-06,49
งาม,40,0.000129755,10,2.9332E-05,50
งี้,55,0.000177226,26,7.19967E-05,81
งี่เง่า,11,3.7977E-05,0,2.66655E-06,11
งื้ออออ,15,5.0636E-05,0,2.66655E-06,15
งู,38,0.000123425,0,2.66655E-06,38
งูเห่า,0,3.16475E-06,18,5.06644E-05,18
เงา,17,5.69655E-05,0,2.66655E-06,17
เงิน,178,0.00056649,174,0.000466646,352
เงินกู้,0,3.16475E-06,89,0.000239989,89
เงินชดเชย,0,3.16475E-06,10,2.9332E-05,10
เงินเดือน,22,7.27892E-05,27,7.46633E-05,49
เงินบริจาค,0,3.16475E-06,15,4.26647E-05,15
เงี่ย,13,4.43065E-05,0,2.66655E-06,13
เงี้ย,14,4.74712E-05,0,2.66655E-06,14
เงี่ยน,348,0.001104497,0,2.66655E-06,348
เงียบ,48,0.000155073,15,4.26647E-05,63
เงียบๆ,14,4.74712E-05,0,2.66655E-06,14
แง,181,0.000575984,0,2.66655E-06,181
แง่,23,7.59539E-05,0,2.66655E-06,23
แง้,17,5.69655E-05,0,2.66655E-06,17
โง่,52,0.000167732,94,0.000253322,146
จ,118,0.000376605,36,9.86622E-05,154
"จ…""",0,3.16475E-06,22,6.13306E-05,22
จก,15,5.0636E-05,0,2.66655E-06,15
จดหมาย,0,3.16475E-06,33,9.06626E-05,33
จตุจักร,14,4.74712E-05,0,2.66655E-06,14
จนท.,0,3.16475E-06,104,0.000279987,104
จบ,145,0.000462053,100,0.000269321,245
จปร.,0,3.16475E-06,27,7.46633E-05,27
จรรยาบรรณ,0,3.16475E-06,10,2.9332E-05,10
จริง ๆ,10,3.48122E-05,18,5.06644E-05,28
จว.,0,3.16475E-06,82,0.000221323,82
จอ,53,0.000170896,13,3.73316E-05,66
จ่อ,0,3.16475E-06,29,7.99964E-05,29
จอง,114,0.000363946,0,2.66655E-06,114
จ้อง,0,3.16475E-06,10,2.9332E-05,10
จอด,14,4.74712E-05,20,5.59975E-05,34
จ้อน,0,3.16475E-06,10,2.9332E-05,10
จอม,40,0.000129755,20,5.59975E-05,60
จอมปลอม,0,3.16475E-06,37,0.000101329,37
จ่ะ,19,6.32949E-05,0,2.66655E-06,19
จัก,17,5.69655E-05,0,2.66655E-06,17
จักร,0,3.16475E-06,57,0.00015466,57
จักรพงษ์,0,3.16475E-06,17,4.79978E-05,17
จังหวะ,18,6.01302E-05,0,2.66655E-06,18
จังหวัด,49,0.000158237,119,0.000319985,168
จัญไร,0,3.16475E-06,16,4.53313E-05,16
จัดกิจกรรม,0,3.16475E-06,50,0.000135994,50
จัดฉาก,0,3.16475E-06,16,4.53313E-05,16
จัดระเบียบ,0,3.16475E-06,14,3.99982E-05,14
จัน,0,3.16475E-06,27,7.46633E-05,27
จันทบุรี,34,0.000110766,0,2.66655E-06,34
จับกุม,0,3.16475E-06,15,4.26647E-05,15
จับได้,0,3.16475E-06,12,3.46651E-05,12
จับตา,0,3.16475E-06,14,3.99982E-05,14
จับมือ,24,7.91187E-05,25,6.93302E-05,49
จั่ว,0,3.16475E-06,86,0.000231989,86
จา,47,0.000151908,51,0.00013866,98
จ่า,0,3.16475E-06,57,0.00015466,57
จ้าง,14,4.74712E-05,11,3.19985E-05,25
จาน,0,3.16475E-06,12,3.46651E-05,12
จ้าน,28,9.17777E-05,14,3.99982E-05,42
จ่าย,136,0.00043357,50,0.000135994,186
จำกัด,43,0.000139249,0,2.66655E-06,43
จำคุก,0,3.16475E-06,14,3.99982E-05,14
จำได้,16,5.38007E-05,12,3.46651E-05,28
จำนวน,18,6.01302E-05,174,0.000466646,192
จำนวนมาก,0,3.16475E-06,16,4.53313E-05,16
จำเป็นต้อง,10,3.48122E-05,37,0.000101329,47
จำหน่าย,0,3.16475E-06,13,3.73316E-05,13
จิ,42,0.000136084,0,2.66655E-06,42
จิก,0,3.16475E-06,22,6.13306E-05,22
จิง,44,0.000142414,0,2.66655E-06,44
จิงๆ,36,0.000117096,0,2.66655E-06,36
จิต,35,0.000113931,345,0.000922625,380
จิตใจ,13,4.43065E-05,42,0.000114661,55
จิตร,0,3.16475E-06,10,2.9332E-05,10
จิตสำนึก,0,3.16475E-06,35,9.59956E-05,35
จิน,70,0.000224697,0,2.66655E-06,70
จิ้น,25,8.22834E-05,0,2.66655E-06,25
จินดา,0,3.16475E-06,17,4.79978E-05,17
จิบ,24,7.91187E-05,0,2.66655E-06,24
จิ้ม,15,5.0636E-05,0,2.66655E-06,15
จิ๋ว,13,4.43065E-05,0,2.66655E-06,13
จี,85,0.000272168,0,2.66655E-06,85
จี้,32,0.000104437,30,8.26629E-05,62
จีง,13,4.43065E-05,0,2.66655E-06,13
จีน,35,0.000113931,180,0.000482645,215
จีบ,34,0.000110766,0,2.66655E-06,34
จุ,27,8.86129E-05,27,7.46633E-05,54
จุก,53,0.000170896,0,2.66655E-06,53
จุด,56,0.000180391,143,0.000383983,199
จุดชมวิว,11,3.7977E-05,0,2.66655E-06,11
จุน,10,3.48122E-05,0,2.66655E-06,10
จุ๊ย,0,3.16475E-06,14,3.99982E-05,14
จุลจอมเกล้า,0,3.16475E-06,45,0.000122661,45
จุฬา,0,3.16475E-06,17,4.79978E-05,17
จุฬาฯ,0,3.16475E-06,12,3.46651E-05,12
จู,11,3.7977E-05,0,2.66655E-06,11
จูบ,33,0.000107601,11,3.19985E-05,44
เจ,76,0.000243686,22,6.13306E-05,98
เจ้,14,4.74712E-05,11,3.19985E-05,25
เจ๊,19,6.32949E-05,18,5.06644E-05,37
เจ็ด,46,0.000148743,0,2.66655E-06,46
เจดีย์,14,4.74712E-05,0,2.66655E-06,14
เจตนา,0,3.16475E-06,31,8.53295E-05,31
เจน,18,6.01302E-05,0,2.66655E-06,18
เจ็บ,64,0.000205709,21,5.8664E-05,85
เจ็บปวด,12,4.11417E-05,0,2.66655E-06,12
เจริญ,52,0.000167732,376,0.001005288,428
เจล,24,7.91187E-05,10,2.9332E-05,34
เจอ,459,0.001455784,114,0.000306653,573
เจอกัน,177,0.000563325,27,7.46633E-05,204
เจ้า,106,0.000338628,103,0.000277321,209
เจ้าของ,43,0.000139249,24,6.66636E-05,67
เจ้าของร้าน,11,3.7977E-05,0,2.66655E-06,11
เจ้าคะ,0,3.16475E-06,21,5.8664E-05,21
เจ้าค่ะ,0,3.16475E-06,28,7.73298E-05,28
เจ้าพระยา,0,3.16475E-06,27,7.46633E-05,27
เจ้าฟ้า,0,3.16475E-06,45,0.000122661,45
เจ้าหน้า,0,3.16475E-06,12,3.46651E-05,12
เจ้าหน้าที่,0,3.16475E-06,355,0.00094929,355
เจ้าหน้าที่ตำรวจ,0,3.16475E-06,41,0.000111995,41
เจี๊ยบ,0,3.16475E-06,10,2.9332E-05,10
แจ,46,0.000148743,0,2.66655E-06,46
แจก,131,0.000417747,224,0.000599973,355
แจกจ่าย,0,3.16475E-06,168,0.000450646,168
แจง,0,3.16475E-06,66,0.000178659,66
แจ้ง,59,0.000189885,76,0.000205324,135
แจ้งความ,0,3.16475E-06,53,0.000143993,53
แจ่ม,10,3.48122E-05,0,2.66655E-06,10
โจ้,13,4.43065E-05,0,2.66655E-06,13
โจ๊ก,0,3.16475E-06,15,4.26647E-05,15
โจมตี,0,3.16475E-06,49,0.000133327,49
โจร,0,3.16475E-06,96,0.000258655,96
ใจ,296,0.00093993,181,0.000485311,477
ใจดี,51,0.000164567,0,2.66655E-06,51
ใจมา,10,3.48122E-05,0,2.66655E-06,10
ใจเย็น,19,6.32949E-05,15,4.26647E-05,34
ฉก,0,3.16475E-06,92,0.000247989,92
ฉบับ,0,3.16475E-06,44,0.000119995,44
ฉลอง,19,6.32949E-05,10,2.9332E-05,29
ฉอด,0,3.16475E-06,10,2.9332E-05,10
ฉาก,27,8.86129E-05,0,2.66655E-06,27
ฉาง,12,4.11417E-05,0,2.66655E-06,12
ฉาย,20,6.64597E-05,0,2.66655E-06,20
ฉายา,0,3.16475E-06,16,4.53313E-05,16
ฉีก,15,5.0636E-05,0,2.66655E-06,15
ฉีด,20,6.64597E-05,20,5.59975E-05,40
ฉุกเฉิน,0,3.16475E-06,32,8.7996E-05,32
เฉ,0,3.16475E-06,13,3.73316E-05,13
เฉลิม,0,3.16475E-06,22,6.13306E-05,22
แฉ,0,3.16475E-06,24,6.66636E-05,24
ช,26,8.54482E-05,36,9.86622E-05,62
ช.,0,3.16475E-06,10,2.9332E-05,10
ช.ม,14,4.74712E-05,0,2.66655E-06,14
ช…,0,3.16475E-06,23,6.39971E-05,23
"ช…""",0,3.16475E-06,15,4.26647E-05,15
ชง,12,4.11417E-05,14,3.99982E-05,26
ชน,41,0.000132919,52,0.000141327,93
ชนะ,17,5.69655E-05,59,0.000159993,76
ชม,134,0.000427241,131,0.000351984,265
ชม.,43,0.000139249,0,2.66655E-06,43
ชมเชย,0,3.16475E-06,42,0.000114661,42
ชมพู,17,5.69655E-05,0,2.66655E-06,17
ชยันตี,24,7.91187E-05,0,2.66655E-06,24
ชลบุรี,92,0.000294321,16,4.53313E-05,108
ชลมารค,0,3.16475E-06,170,0.000455979,170
ช่วงเวลา,13,4.43065E-05,26,7.19967E-05,39
ชวน,70,0.000224697,59,0.000159993,129
ช่วยกัน,23,7.59539E-05,195,0.000522643,218
ช่วยตัวเอง,22,7.27892E-05,0,2.66655E-06,22
ช่วยเหลือ,35,0.000113931,648,0.001730588,683
ช่อ,0,3.16475E-06,152,0.000407982,152
ช่อง,96,0.00030698,116,0.000311986,212
ช่องทาง,0,3.16475E-06,11,3.19985E-05,11
ชอน,10,3.48122E-05,0,2.66655E-06,10
ช้อน,0,3.16475E-06,41,0.000111995,41
ชอบ,716,0.002269124,215,0.000575974,931
ช้อป,26,8.54482E-05,0,2.66655E-06,26
ชะ,13,4.43065E-05,10,2.9332E-05,23
ชะลอ,0,3.16475E-06,11,3.19985E-05,11
ชักเย่อ,0,3.16475E-06,13,3.73316E-05,13
ชักว่าว,18,6.01302E-05,0,2.66655E-06,18
ชัค,10,3.48122E-05,0,2.66655E-06,10
ชัง,0,3.16475E-06,123,0.000330652,123
ชัด,59,0.000189885,52,0.000141327,111
ชัดเจน,36,0.000117096,56,0.000151993,92
ชั่น,281,0.000892459,15,4.26647E-05,296
ชั้น,234,0.000743716,32,8.7996E-05,266
ชั้นผู้น้อย,0,3.16475E-06,40,0.000109328,40
ชัย,29,9.49424E-05,132,0.000354651,161
ชัยนาท,31,0.000101272,13,3.73316E-05,44
ชั่ว,0,3.16475E-06,30,8.26629E-05,30
ชั่วคราว,18,6.01302E-05,11,3.19985E-05,29
ชั่วโมง,58,0.00018672,26,7.19967E-05,84
ชัวร์,12,4.11417E-05,0,2.66655E-06,12
ชา,71,0.000227862,19,5.33309E-05,90
ช่าง,43,0.000139249,46,0.000125328,89
ช้าง,34,0.000110766,13,3.73316E-05,47
ชาญ,0,3.16475E-06,11,3.19985E-05,11
ชาติ,217,0.000689915,442,0.00118128,659
ชานุ,0,3.16475E-06,14,3.99982E-05,14
ชาบู,25,8.22834E-05,0,2.66655E-06,25
ชาย,185,0.000588643,60,0.000162659,245
ช่าย,36,0.000117096,0,2.66655E-06,36
ชายแดน,0,3.16475E-06,186,0.000498644,186
ชาร์จ,13,4.43065E-05,0,2.66655E-06,13
ชาวเขา,0,3.16475E-06,28,7.73298E-05,28
ชาวไทย,0,3.16475E-06,27,7.46633E-05,27
ชาวนา,0,3.16475E-06,14,3.99982E-05,14
ชาวบ้าน,12,4.11417E-05,60,0.000162659,72
ชำนาญ,0,3.16475E-06,12,3.46651E-05,12
ชิ,59,0.000189885,19,5.33309E-05,78
ชิง,12,4.11417E-05,74,0.000199991,86
ชิน,21,6.96244E-05,0,2.66655E-06,21
ชิ้น,54,0.000174061,37,0.000101329,91
ชิบหาย,42,0.000136084,24,6.66636E-05,66
ชิป,40,0.000129755,0,2.66655E-06,40
ชิม,20,6.64597E-05,0,2.66655E-06,20
ชิล,21,6.96244E-05,0,2.66655E-06,21
ชิวๆ,20,6.64597E-05,17,4.79978E-05,37
ชี,11,3.7977E-05,23,6.39971E-05,34
ชี้,17,5.69655E-05,142,0.000381316,159
ชี้แจง,0,3.16475E-06,45,0.000122661,45
ชีวิต,160,0.000509524,228,0.000610639,388
ชื่น,11,3.7977E-05,0,2.66655E-06,11
ชื่นชม,0,3.16475E-06,236,0.000631971,236
ชื่อ,79,0.00025318,71,0.000191991,150
ชุด,130,0.000414582,225,0.000602639,355
ชุมชน,13,4.43065E-05,49,0.000133327,62
ชุมนุม,11,3.7977E-05,60,0.000162659,71
ชุมพร,25,8.22834E-05,0,2.66655E-06,25
ชู,14,4.74712E-05,52,0.000141327,66
เช็ค,49,0.000158237,39,0.000106662,88
เช่า,11,3.7977E-05,0,2.66655E-06,11
เช้า,75,0.000240521,73,0.000197324,148
เช้านี้,13,4.43065E-05,62,0.000167992,75
เชิง,0,3.16475E-06,34,9.33291E-05,34
เชิญ,24,7.91187E-05,96,0.000258655,120
เชิญชวน,17,5.69655E-05,38,0.000103995,55
เชิดชู,0,3.16475E-06,56,0.000151993,56
เชียงคาน,11,3.7977E-05,0,2.66655E-06,11
เชียงราย,44,0.000142414,27,7.46633E-05,71
เชียงใหม่,449,0.001424136,48,0.000130661,497
เชียร์,28,9.17777E-05,53,0.000143993,81
เชี่ยลฯ,0,3.16475E-06,10,2.9332E-05,10
เชียว,25,8.22834E-05,11,3.19985E-05,36
เชื้อ,17,5.69655E-05,61,0.000165326,78
เชื่อใจ,13,4.43065E-05,0,2.66655E-06,13
เชื่อม,0,3.16475E-06,15,4.26647E-05,15
เชื่อมต่อ,0,3.16475E-06,10,2.9332E-05,10
เชื้อโรค,0,3.16475E-06,29,7.99964E-05,29
เชื้อไวรัส,0,3.16475E-06,125,0.000335985,125
แช,20,6.64597E-05,0,2.66655E-06,20
แช่,23,7.59539E-05,0,2.66655E-06,23
แชท,56,0.000180391,0,2.66655E-06,56
แชร์,26,8.54482E-05,94,0.000253322,120
โชค,95,0.000303816,10,2.9332E-05,105
โชคดี,27,8.86129E-05,11,3.19985E-05,38
โชว์,55,0.000177226,41,0.000111995,96
ใช้งาน,0,3.16475E-06,14,3.99982E-05,14
ใช้ชีวิต,29,9.49424E-05,15,4.26647E-05,44
ใช้ได้,25,8.22834E-05,0,2.66655E-06,25
ใช้เวลา,12,4.11417E-05,0,2.66655E-06,12
ไชย,0,3.16475E-06,20,5.59975E-05,20
ซ์,31,0.000101272,0,2.66655E-06,31
ซ,11,3.7977E-05,0,2.66655E-06,11
ซ.,14,4.74712E-05,0,2.66655E-06,14
ซน,32,0.000104437,0,2.66655E-06,32
ซบ,17,5.69655E-05,0,2.66655E-06,17
ซวย,0,3.16475E-06,15,4.26647E-05,15
ซอ,13,4.43065E-05,0,2.66655E-06,13
ซอง,28,9.17777E-05,0,2.66655E-06,28
ซ่อน,10,3.48122E-05,0,2.66655E-06,10
ซ่อม,34,0.000110766,46,0.000125328,80
ซ้อม,27,8.86129E-05,12,3.46651E-05,39
ซ่อมแซม,0,3.16475E-06,14,3.99982E-05,14
ซอมบี้,0,3.16475E-06,13,3.73316E-05,13
ซอย,47,0.000151908,17,4.79978E-05,64
ซอส,11,3.7977E-05,0,2.66655E-06,11
ซัก,58,0.00018672,33,9.06626E-05,91
ซักฟอก,0,3.16475E-06,11,3.19985E-05,11
ซัด,0,3.16475E-06,15,4.26647E-05,15
ซัพพอร์ต,19,6.32949E-05,0,2.66655E-06,19
ซา,52,0.000167732,0,2.66655E-06,52
ซ่า,14,4.74712E-05,0,2.66655E-06,14
ซ่าน,10,3.48122E-05,0,2.66655E-06,10
ซ้าย,10,3.48122E-05,0,2.66655E-06,10
ซ้ำ,13,4.43065E-05,50,0.000135994,63
ซิ,48,0.000155073,10,2.9332E-05,58
ซิ่ง,15,5.0636E-05,0,2.66655E-06,15
ซิตี้,15,5.0636E-05,0,2.66655E-06,15
ซี,70,0.000224697,117,0.000314652,187
ซี่,17,5.69655E-05,0,2.66655E-06,17
ซีน,31,0.000101272,0,2.66655E-06,31
ซีรีส์,21,6.96244E-05,0,2.66655E-06,21
ซึง,16,5.38007E-05,0,2.66655E-06,16
ซึม,0,3.16475E-06,15,4.26647E-05,15
ซึมเศร้า,14,4.74712E-05,0,2.66655E-06,14
ซื้อ,255,0.000810175,84,0.000226656,339
ซุป,10,3.48122E-05,0,2.66655E-06,10
ซุ่ม,0,3.16475E-06,19,5.33309E-05,19
ซู,18,6.01302E-05,0,2.66655E-06,18
ซูดาน,0,3.16475E-06,14,3.99982E-05,14
ซูม,10,3.48122E-05,0,2.66655E-06,10
เซ,104,0.000332298,20,5.59975E-05,124
เซ่,29,9.49424E-05,0,2.66655E-06,29
เซ็ก,10,3.48122E-05,0,2.66655E-06,10
เซ็กส์,12,4.11417E-05,0,2.66655E-06,12
เซ็ต,14,4.74712E-05,0,2.66655E-06,14
เซน,10,3.48122E-05,0,2.66655E-06,10
เซ็น,12,4.11417E-05,22,6.13306E-05,34
เซ็นทรัล,14,4.74712E-05,0,2.66655E-06,14
เซฟ,28,9.17777E-05,0,2.66655E-06,28
เซเว่น,14,4.74712E-05,0,2.66655E-06,14
แซบ,11,3.7977E-05,0,2.66655E-06,11
แซ่บ,52,0.000167732,0,2.66655E-06,52
แซว,25,8.22834E-05,0,2.66655E-06,25
แซะ,0,3.16475E-06,36,9.86622E-05,36
โซ,16,5.38007E-05,36,9.86622E-05,52
โซเชียล,0,3.16475E-06,56,0.000151993,56
โซน,28,9.17777E-05,0,2.66655E-06,28
ไซ,30,9.81072E-05,0,2.66655E-06,30
ไซด์ไลน์,327,0.001038037,0,2.66655E-06,327
ไซต์,0,3.16475E-06,38,0.000103995,38
ไซส์,23,7.59539E-05,0,2.66655E-06,23
ญ,31,0.000101272,0,2.66655E-06,31
ญ.,14,4.74712E-05,0,2.66655E-06,14
ญัตติ,0,3.16475E-06,23,6.39971E-05,23
ญา,10,3.48122E-05,40,0.000109328,50
ญาณ,0,3.16475E-06,14,3.99982E-05,14
ญาติ,12,4.11417E-05,100,0.000269321,112
ญี่ปุ่น,23,7.59539E-05,71,0.000191991,94
ฏ,0,3.16475E-06,31,8.53295E-05,31
ฐาน,11,3.7977E-05,31,8.53295E-05,42
ฐานะ,0,3.16475E-06,49,0.000133327,49
ณ์,0,3.16475E-06,17,4.79978E-05,17
ณ…,0,3.16475E-06,10,2.9332E-05,10
ณะ,0,3.16475E-06,12,3.46651E-05,12
ณัฐ,0,3.16475E-06,24,6.66636E-05,24
ณัฐพล,0,3.16475E-06,37,0.000101329,37
ณา,0,3.16475E-06,26,7.19967E-05,26
ณี,0,3.16475E-06,26,7.19967E-05,26
ด์,16,5.38007E-05,16,4.53313E-05,32
ด,132,0.000420911,25,6.93302E-05,157
ด้…,0,3.16475E-06,16,4.53313E-05,16
ดง,21,6.96244E-05,65,0.000175992,86
ดด,27,8.86129E-05,0,2.66655E-06,27
ดดด,25,8.22834E-05,0,2.66655E-06,25
ดดดด,18,6.01302E-05,0,2.66655E-06,18
ดดดดด,15,5.0636E-05,0,2.66655E-06,15
ดดดดดดด,10,3.48122E-05,0,2.66655E-06,10
ดนตรี,13,4.43065E-05,0,2.66655E-06,13
ดม,12,4.11417E-05,0,2.66655E-06,12
ดร.,0,3.16475E-06,19,5.33309E-05,19
ดราม่า,14,4.74712E-05,0,2.66655E-06,14
ด้ว…,0,3.16475E-06,10,2.9332E-05,10
ดวง,11,3.7977E-05,63,0.000170659,74
ดวงใจ,50,0.000161402,0,2.66655E-06,50
ด่วน,75,0.000240521,108,0.000290653,183
ด้วยใจ,10,3.48122E-05,65,0.000175992,75
ด้วยดี,0,3.16475E-06,15,4.26647E-05,15
ดอก,44,0.000142414,50,0.000135994,94
ดอกไม้,33,0.000107601,0,2.66655E-06,33
ดอง,11,3.7977E-05,0,2.66655E-06,11
ดอน,13,4.43065E-05,0,2.66655E-06,13
ดอนเมือง,10,3.48122E-05,0,2.66655E-06,10
ด้อม,33,0.000107601,0,2.66655E-06,33
ดอย,44,0.000142414,16,4.53313E-05,60
ดังใจ,0,3.16475E-06,12,3.46651E-05,12
ดัน,13,4.43065E-05,19,5.33309E-05,32
ดับ,14,4.74712E-05,251,0.00067197,265
ดับไฟ,0,3.16475E-06,96,0.000258655,96
์ดัม,0,3.16475E-06,18,5.06644E-05,18
ดา,30,9.81072E-05,12,3.46651E-05,42
ด่า,104,0.000332298,239,0.000639971,343
ดาก,20,6.64597E-05,0,2.66655E-06,20
ด่าน,0,3.16475E-06,100,0.000269321,100
ด้านหลัง,0,3.16475E-06,14,3.99982E-05,14
ดาบ,11,3.7977E-05,18,5.06644E-05,29
ดารา,14,4.74712E-05,15,4.26647E-05,29
ดาว,48,0.000155073,0,2.66655E-06,48
ดาวน์,18,6.01302E-05,0,2.66655E-06,18
ด่าว่า,0,3.16475E-06,10,2.9332E-05,10
ดำ,83,0.000265839,34,9.33291E-05,117
ดำเนิน,0,3.16475E-06,84,0.000226656,84
ดำเนินการ,0,3.16475E-06,92,0.000247989,92
ดำเนินคดี,0,3.16475E-06,30,8.26629E-05,30
ดำเนินงาน,0,3.16475E-06,13,3.73316E-05,13
ดิ,128,0.000408252,46,0.000125328,174
ดิ่ง,13,4.43065E-05,0,2.66655E-06,13
ดิน,30,9.81072E-05,24,6.66636E-05,54
ดิ้น,0,3.16475E-06,58,0.000157326,58
ดิส,16,5.38007E-05,0,2.66655E-06,16
ดี,1376,0.004357857,1023,0.002730543,2399
ดี๊,15,5.0636E-05,0,2.66655E-06,15
ดีกว่า,100,0.000319639,136,0.000365317,236
ดีขึ้น,24,7.91187E-05,57,0.00015466,81
ดีงาม,21,6.96244E-05,0,2.66655E-06,21
ดีใจ,95,0.000303816,28,7.73298E-05,123
ดีด,10,3.48122E-05,0,2.66655E-06,10
ดีเดย์,0,3.16475E-06,11,3.19985E-05,11
ดีมาก,156,0.000496865,114,0.000306653,270
ดีไม่ดี,0,3.16475E-06,13,3.73316E-05,13
ดีล,18,6.01302E-05,0,2.66655E-06,18
ดีแล้ว,21,6.96244E-05,79,0.000213324,100
ดึก,28,9.17777E-05,20,5.59975E-05,48
ดึง,16,5.38007E-05,16,4.53313E-05,32
ดื่ม,26,8.54482E-05,18,5.06644E-05,44
ดือ,12,4.11417E-05,0,2.66655E-06,12
ดื้อ,29,9.49424E-05,0,2.66655E-06,29
ดุ,36,0.000117096,0,2.66655E-06,36
ดุจ,0,3.16475E-06,13,3.73316E-05,13
ดุล,18,6.01302E-05,0,2.66655E-06,18
ดู,818,0.002591928,446,0.001191946,1264
ดูด,88,0.000281663,0,2.66655E-06,88
ดูดซับ,0,3.16475E-06,11,3.19985E-05,11
ดูดนม,14,4.74712E-05,0,2.66655E-06,14
ดูดวง,19,6.32949E-05,0,2.66655E-06,19
ดูดี,17,5.69655E-05,0,2.66655E-06,17
ดูไม่ได้,0,3.16475E-06,18,5.06644E-05,18
ดูแล,85,0.000272168,281,0.000751966,366
ดูแลตัวเอง,24,7.91187E-05,17,4.79978E-05,41
ดูแลรักษา,0,3.16475E-06,14,3.99982E-05,14
ดูออก,15,5.0636E-05,0,2.66655E-06,15
เด,68,0.000218368,51,0.00013866,119
เด่,44,0.000142414,0,2.66655E-06,44
เด้,25,8.22834E-05,0,2.66655E-06,25
เด็ก,276,0.000876635,191,0.000511977,467
เด้ง,25,8.22834E-05,17,4.79978E-05,42
เดช,10,3.48122E-05,22,6.13306E-05,32
เด็ด,76,0.000243686,16,4.53313E-05,92
เด็ดขาด,0,3.16475E-06,18,5.06644E-05,18
เด่น,0,3.16475E-06,16,4.53313E-05,16
เดย์,12,4.11417E-05,0,2.66655E-06,12
เดลินิวส์,0,3.16475E-06,10,2.9332E-05,10
เด๋ว,19,6.32949E-05,0,2.66655E-06,19
เด้อ,56,0.000180391,0,2.66655E-06,56
เดอะ,30,9.81072E-05,0,2.66655E-06,30
เดะ,27,8.86129E-05,0,2.66655E-06,27
เดิน,204,0.000648773,123,0.000330652,327
เดินทาง,44,0.000142414,141,0.00037865,185
เดินทางไกล,0,3.16475E-06,14,3.99982E-05,14
เดินเท้า,0,3.16475E-06,20,5.59975E-05,20
เดินเล่น,18,6.01302E-05,0,2.66655E-06,18
เดินหน้า,0,3.16475E-06,110,0.000295987,110
เดิม,63,0.000202544,42,0.000114661,105
์เดียน,0,3.16475E-06,132,0.000354651,132
เดียร,0,3.16475E-06,14,3.99982E-05,14
เดี่ยว,63,0.000202544,17,4.79978E-05,80
เดี๋ยว,150,0.000477877,54,0.00014666,204
เดี๋ยวนี้,14,4.74712E-05,0,2.66655E-06,14
เดือด,0,3.16475E-06,15,4.26647E-05,15
เดือดร้อน,0,3.16475E-06,40,0.000109328,40
เดือน,132,0.000420911,72,0.000194658,204
แด,10,3.48122E-05,0,2.66655E-06,10
แด่,12,4.11417E-05,0,2.66655E-06,12
แดก,66,0.000212038,15,4.26647E-05,81
แดง,79,0.00025318,342,0.000914625,421
แดด,35,0.000113931,0,2.66655E-06,35
โด,39,0.00012659,30,8.26629E-05,69
โดด,15,5.0636E-05,0,2.66655E-06,15
โดน,402,0.001275393,252,0.000674636,654
โดนัท,16,5.38007E-05,0,2.66655E-06,16
โดยเฉพาะ,13,4.43065E-05,22,6.13306E-05,35
โดยเร็ว,0,3.16475E-06,14,3.99982E-05,14
โดยสวัสดิภาพ,0,3.16475E-06,10,2.9332E-05,10
ใด,52,0.000167732,81,0.000218657,133
ใด้,16,5.38007E-05,0,2.66655E-06,16
ได,35,0.000113931,18,5.06644E-05,53
ได้ใจ,0,3.16475E-06,17,4.79978E-05,17
ได้ดี,18,6.01302E-05,38,0.000103995,56
ได้ยิน,34,0.000110766,0,2.66655E-06,34
ได้รับบาดเจ็บ,0,3.16475E-06,49,0.000133327,49
ต,129,0.000411417,92,0.000247989,221
ต.,32,0.000104437,118,0.000317319,150
ต่…,0,3.16475E-06,13,3.73316E-05,13
"ต…""",0,3.16475E-06,34,9.33291E-05,34
ตก,77,0.00024685,35,9.59956E-05,112
ตกใจ,33,0.000107601,19,5.33309E-05,52
ตกเป็น,0,3.16475E-06,16,4.53313E-05,16
ตกลง,14,4.74712E-05,12,3.46651E-05,26
ตจ,14,4.74712E-05,0,2.66655E-06,14
ต้น,62,0.000199379,24,6.66636E-05,86
ต้นไม้,0,3.16475E-06,26,7.19967E-05,26
ตบ,11,3.7977E-05,0,2.66655E-06,11
ตม.,0,3.16475E-06,17,4.79978E-05,17
ต้มยำ,21,6.96244E-05,0,2.66655E-06,21
ตร.,0,3.16475E-06,104,0.000279987,104
ตรงข้าม,29,9.49424E-05,0,2.66655E-06,29
ตรงนี้,39,0.00012659,0,2.66655E-06,39
ตรงไหน,33,0.000107601,39,0.000106662,72
ตรวจ,28,9.17777E-05,268,0.000717301,296
ตรวจตรา,0,3.16475E-06,13,3.73316E-05,13
ตรวจสอบ,0,3.16475E-06,87,0.000234656,87
ตระกูล,0,3.16475E-06,11,3.19985E-05,11
ตรัง,25,8.22834E-05,0,2.66655E-06,25
ตราด,50,0.000161402,0,2.66655E-06,50
ตราบ,55,0.000177226,0,2.66655E-06,55
ตรู,11,3.7977E-05,0,2.66655E-06,11
ตลก,46,0.000148743,24,6.66636E-05,70
ตลอดคืน,0,3.16475E-06,15,4.26647E-05,15
ตลาด,81,0.000259509,0,2.66655E-06,81
ตลาดนัด,180,0.000572819,0,2.66655E-06,180
ตอ,10,3.48122E-05,25,6.93302E-05,35
ต้องการ,57,0.000183555,58,0.000157326,115
ต้องหา,15,5.0636E-05,0,2.66655E-06,15
ต่อต้าน,0,3.16475E-06,13,3.73316E-05,13
ตอน,279,0.000886129,89,0.000239989,368
ตอนที่,13,4.43065E-05,0,2.66655E-06,13
ตอนนั้น,20,6.64597E-05,10,2.9332E-05,30
ตอนนี้,324,0.001028543,127,0.000341318,451
ตอนเย็น,20,6.64597E-05,0,2.66655E-06,20
ต้อนรับ,14,4.74712E-05,51,0.00013866,65
ตอนแรก,42,0.000136084,27,7.46633E-05,69
ต่อเนื่อง,0,3.16475E-06,68,0.000183992,68
ตอบ,117,0.00037344,54,0.00014666,171
ต่อไป,65,0.000208873,257,0.000687969,322
ต่อมา,22,7.27892E-05,0,2.66655E-06,22
ต่อสู้,0,3.16475E-06,20,5.59975E-05,20
ต่อหน้า,0,3.16475E-06,13,3.73316E-05,13
ตอแหล,15,5.0636E-05,45,0.000122661,60
ต่อให้,16,5.38007E-05,24,6.66636E-05,40
ตะ,53,0.000170896,30,8.26629E-05,83
ตะวัน,64,0.000205709,0,2.66655E-06,64
ตะวันออก,0,3.16475E-06,10,2.9332E-05,10
ตั…,0,3.16475E-06,10,2.9332E-05,10
ตัก,14,4.74712E-05,0,2.66655E-06,14
ตักบาตร,0,3.16475E-06,12,3.46651E-05,12
ตัง,56,0.000180391,0,2.66655E-06,56
ตังค์,22,7.27892E-05,0,2.66655E-06,22
ตั้งใจ,43,0.000139249,31,8.53295E-05,74
ตัด,44,0.000142414,49,0.000133327,93
ตัดสิทธิ์,0,3.16475E-06,21,5.8664E-05,21
ตัดสิน,12,4.11417E-05,77,0.000207991,89
ตัน,0,3.16475E-06,10,2.9332E-05,10
ตับ,10,3.48122E-05,0,2.66655E-06,10
ตัว,255,0.000810175,130,0.000349317,385
ตัวจริง,25,8.22834E-05,16,4.53313E-05,41
ตัวแทน,0,3.16475E-06,34,9.33291E-05,34
ตัวเมือง,56,0.000180391,0,2.66655E-06,56
ตัวเรา,13,4.43065E-05,10,2.9332E-05,23
ตัวเล็ก,34,0.000110766,0,2.66655E-06,34
ตัวเลข,0,3.16475E-06,38,0.000103995,38
ตัวอย่าง,15,5.0636E-05,31,8.53295E-05,46
ตัวเอง,301,0.000955754,295,0.000789298,596
ตา,137,0.000436735,116,0.000311986,253
ตาก,16,5.38007E-05,14,3.99982E-05,30
ต่าง ๆ,0,3.16475E-06,12,3.46651E-05,12
ต่างกัน,14,4.74712E-05,10,2.9332E-05,24
ต่างจังหวัด,12,4.11417E-05,0,2.66655E-06,12
ต่างชาติ,11,3.7977E-05,20,5.59975E-05,31
ต่างประเทศ,0,3.16475E-06,35,9.59956E-05,35
ต่างหู,12,4.11417E-05,0,2.66655E-06,12
ต้าน,10,3.48122E-05,77,0.000207991,87
ตามใจ,14,4.74712E-05,0,2.66655E-06,14
ตามนั้น,0,3.16475E-06,15,4.26647E-05,15
ตามมา,25,8.22834E-05,19,5.33309E-05,44
ตามระเบียบ,0,3.16475E-06,10,2.9332E-05,10
ตามหา,28,9.17777E-05,0,2.66655E-06,28
ตาย,161,0.000512689,157,0.000421314,318
ต้าว,37,0.00012026,0,2.66655E-06,37
ตาสว่าง,10,3.48122E-05,0,2.66655E-06,10
ตำ,16,5.38007E-05,67,0.000181325,83
ต่ำ,15,5.0636E-05,22,6.13306E-05,37
ตำนาน,11,3.7977E-05,15,4.26647E-05,26
ตำบล,0,3.16475E-06,20,5.59975E-05,20
ตำรวจ,19,6.32949E-05,198,0.000530643,217
ตำหนิ,0,3.16475E-06,15,4.26647E-05,15
ตำแหน่ง,0,3.16475E-06,29,7.99964E-05,29
ติ,24,7.91187E-05,74,0.000199991,98
ติ่ง,67,0.000215203,48,0.000130661,115
ติด,202,0.000642444,187,0.000501311,389
ติดคุก,0,3.16475E-06,25,6.93302E-05,25
ติดเชื้อ,21,6.96244E-05,210,0.000562641,231
ติดต่อ,55,0.000177226,12,3.46651E-05,67
ติดต่อสอบถาม,13,4.43065E-05,0,2.66655E-06,13
ติดตาม,53,0.000170896,250,0.000669303,303
ตี,67,0.000215203,80,0.00021599,147
ตี้,13,4.43065E-05,0,2.66655E-06,13
ตี๋,23,7.59539E-05,28,7.73298E-05,51
ตีน,27,8.86129E-05,18,5.06644E-05,45
ตึก,20,6.64597E-05,0,2.66655E-06,20
ตื่น,101,0.000322804,21,5.8664E-05,122
ตื่นตระหนก,0,3.16475E-06,20,5.59975E-05,20
ตื่นเต้น,27,8.86129E-05,0,2.66655E-06,27
ตุ,18,6.01302E-05,0,2.66655E-06,18
ตุ๊กตา,12,4.11417E-05,0,2.66655E-06,12
ตุน,12,4.11417E-05,0,2.66655E-06,12
ตุ๋น,10,3.48122E-05,0,2.66655E-06,10
ตุลาการ,0,3.16475E-06,22,6.13306E-05,22
ตู่,18,6.01302E-05,209,0.000559975,227
ตู้,14,4.74712E-05,0,2.66655E-06,14
ตูด,24,7.91187E-05,0,2.66655E-06,24
ตูน,0,3.16475E-06,17,4.79978E-05,17
เต,123,0.000392429,44,0.000119995,167
เตก,0,3.16475E-06,11,3.19985E-05,11
เต้น,63,0.000202544,0,2.66655E-06,63
เต็ม,118,0.000376605,50,0.000135994,168
เต็มกำลัง,0,3.16475E-06,13,3.73316E-05,13
เต็มที่,18,6.01302E-05,70,0.000189325,88
เตรียม,47,0.000151908,260,0.000695968,307
เตรียมการ,0,3.16475E-06,12,3.46651E-05,12
เตรียมตัว,0,3.16475E-06,10,2.9332E-05,10
เตรียมพร้อม,0,3.16475E-06,39,0.000106662,39
เต่า,13,4.43065E-05,0,2.66655E-06,13
เติม,31,0.000101272,90,0.000242656,121
เตี้ย,11,3.7977E-05,0,2.66655E-06,11
เตียง,32,0.000104437,19,5.33309E-05,51
เตือน,17,5.69655E-05,74,0.000199991,91
แต้,11,3.7977E-05,0,2.66655E-06,11
แตก,136,0.00043357,22,6.13306E-05,158
แตกแยก,0,3.16475E-06,13,3.73316E-05,13
แต่กลับ,0,3.16475E-06,28,7.73298E-05,28
แตง,16,5.38007E-05,0,2.66655E-06,16
แต่ง,57,0.000183555,56,0.000151993,113
แต่งงาน,10,3.48122E-05,0,2.66655E-06,10
แต่งตั้ง,0,3.16475E-06,10,2.9332E-05,10
แต่งตัว,18,6.01302E-05,0,2.66655E-06,18
โต้,11,3.7977E-05,0,2.66655E-06,11
โตมา,0,3.16475E-06,11,3.19985E-05,11
โต๊ะ,29,9.49424E-05,0,2.66655E-06,29
ไต,0,3.16475E-06,57,0.00015466,57
ไต่สวน,0,3.16475E-06,10,2.9332E-05,10
ไต้หวัน,0,3.16475E-06,16,4.53313E-05,16
ถ.,15,5.0636E-05,0,2.66655E-06,15
ถก,0,3.16475E-06,19,5.33309E-05,19
ถนน,53,0.000170896,89,0.000239989,142
ถม,0,3.16475E-06,12,3.46651E-05,12
ถล่ม,0,3.16475E-06,30,8.26629E-05,30
ถวาย,12,4.11417E-05,19,5.33309E-05,31
ถวายสัตย์ปฏิญาณ,0,3.16475E-06,15,4.26647E-05,15
ถอด,34,0.000110766,20,5.59975E-05,54
ถอย,12,4.11417E-05,35,9.59956E-05,47
ถอยหลัง,0,3.16475E-06,16,4.53313E-05,16
ถั…,0,3.16475E-06,18,5.06644E-05,18
ถัง,18,6.01302E-05,0,2.66655E-06,18
ถาม,168,0.000534842,120,0.000322652,288
ถ่าย,106,0.000338628,10,2.9332E-05,116
ถ่ายทอด,0,3.16475E-06,11,3.19985E-05,11
ถ่ายทอดสด,0,3.16475E-06,12,3.46651E-05,12
ถ่ายแบบ,11,3.7977E-05,0,2.66655E-06,11
ถ่ายรูป,79,0.00025318,0,2.66655E-06,79
ถ้ำ,14,4.74712E-05,12,3.46651E-05,26
ถึงกับ,13,4.43065E-05,11,3.19985E-05,24
ถึงขนาด,0,3.16475E-06,10,2.9332E-05,10
ถึงที่สุด,0,3.16475E-06,13,3.73316E-05,13
ถือกำเนิด,0,3.16475E-06,11,3.19985E-05,11
ถือเป็น,0,3.16475E-06,18,5.06644E-05,18
ถุง,108,0.000344957,35,9.59956E-05,143
ถุงพลาสติก,0,3.16475E-06,18,5.06644E-05,18
ถุงยาง,13,4.43065E-05,0,2.66655E-06,13
ถูกจับ,0,3.16475E-06,11,3.19985E-05,11
ถูกใจ,32,0.000104437,12,3.46651E-05,44
ถูกวิธี,0,3.16475E-06,22,6.13306E-05,22
เถียง,14,4.74712E-05,17,4.79978E-05,31
แถ,0,3.16475E-06,28,7.73298E-05,28
แถม,90,0.000287992,34,9.33291E-05,124
แถลง,0,3.16475E-06,83,0.00022399,83
แถลงการณ์,0,3.16475E-06,48,0.000130661,48
แถลงข่าว,0,3.16475E-06,64,0.000173325,64
แถว,137,0.000436735,39,0.000106662,176
โถ,0,3.16475E-06,11,3.19985E-05,11
ท์,0,3.16475E-06,16,4.53313E-05,16
ท,100,0.000319639,55,0.000149327,155
ท.,0,3.16475E-06,14,3.99982E-05,14
ท…,0,3.16475E-06,12,3.46651E-05,12
"ท…""",0,3.16475E-06,21,5.8664E-05,21
ทดสอบ,0,3.16475E-06,68,0.000183992,68
ทน,41,0.000132919,32,8.7996E-05,73
ทนาย,0,3.16475E-06,17,4.79978E-05,17
ทโน่,35,0.000113931,0,2.66655E-06,35
ทบ,0,3.16475E-06,89,0.000239989,89
ทบ.,0,3.16475E-06,381,0.00101862,381
ทบทวน,0,3.16475E-06,18,5.06644E-05,18
ทภ.,0,3.16475E-06,38,0.000103995,38
ทยอย,11,3.7977E-05,0,2.66655E-06,11
ทร,27,8.86129E-05,22,6.13306E-05,49
ทร.,0,3.16475E-06,12,3.46651E-05,12
ทรงคุณค่า,0,3.16475E-06,20,5.59975E-05,20
ทรมาน,10,3.48122E-05,0,2.66655E-06,10
ทรัพย์,15,5.0636E-05,0,2.66655E-06,15
ทราบ,11,3.7977E-05,23,6.39971E-05,34
ทราย,16,5.38007E-05,0,2.66655E-06,16
ทริป,57,0.000183555,0,2.66655E-06,57
ทรู,10,3.48122E-05,0,2.66655E-06,10
ท่วม,40,0.000129755,0,2.66655E-06,40
ทวิ,247,0.000784857,49,0.000133327,296
ทวิตเตอร์,14,4.74712E-05,25,6.93302E-05,39
ทวีต,25,8.22834E-05,16,4.53313E-05,41
ทหาร,34,0.000110766,1956,0.00521843,1990
ทหารกองประจำการ,0,3.16475E-06,10,2.9332E-05,10
ทหารเกณฑ์,0,3.16475E-06,13,3.73316E-05,13
ทหารช่าง,0,3.16475E-06,94,0.000253322,94
ทหารบก,0,3.16475E-06,323,0.000863961,323
ทหารปืนใหญ่,0,3.16475E-06,17,4.79978E-05,17
ทหารผ่านศึก,0,3.16475E-06,108,0.000290653,108
ทหารพราน,0,3.16475E-06,164,0.00043998,164
ทหารม้า,0,3.16475E-06,58,0.000157326,58
ทหารราบ,0,3.16475E-06,208,0.000557308,208
ทหารเรือ,0,3.16475E-06,19,5.33309E-05,19
ทหารอากาศ,0,3.16475E-06,15,4.26647E-05,15
ทอ,12,4.11417E-05,0,2.66655E-06,12
ท้อ,21,6.96244E-05,10,2.9332E-05,31
ทอ.,0,3.16475E-06,21,5.8664E-05,21
ทอง,107,0.000341793,218,0.000583974,325
ท้อง,21,6.96244E-05,12,3.46651E-05,33
ท้องถิ่น,0,3.16475E-06,11,3.19985E-05,11
ท่องเที่ยว,0,3.16475E-06,15,4.26647E-05,15
ทอด,48,0.000155073,0,2.66655E-06,48
ทอดทิ้ง,0,3.16475E-06,42,0.000114661,42
ทอน,0,3.16475E-06,149,0.000399982,149
ท่อน,15,5.0636E-05,0,2.66655E-06,15
ท็อป,12,4.11417E-05,0,2.66655E-06,12
ทะ,17,5.69655E-05,16,4.53313E-05,33
ทะลุ,0,3.16475E-06,14,3.99982E-05,14
ทะเล,90,0.000287992,14,3.99982E-05,104
ทะเลาะ,17,5.69655E-05,20,5.59975E-05,37
ทัก,542,0.001718458,18,5.06644E-05,560
ทักทาย,28,9.17777E-05,0,2.66655E-06,28
ทักษิณ,0,3.16475E-06,56,0.000151993,56
ทั้งคู่,32,0.000104437,0,2.66655E-06,32
ทั้งวัน,38,0.000123425,0,2.66655E-06,38
ทั้งสอง,21,6.96244E-05,0,2.66655E-06,21
ทัต,0,3.16475E-06,10,2.9332E-05,10
ทับ,11,3.7977E-05,0,2.66655E-06,11
ทัพ,0,3.16475E-06,80,0.00021599,80
ทัพเรือ,0,3.16475E-06,18,5.06644E-05,18
ทั่วถึง,0,3.16475E-06,16,4.53313E-05,16
ทั่วประเทศ,0,3.16475E-06,25,6.93302E-05,25
ทั่วไป,10,3.48122E-05,0,2.66655E-06,10
ทั่วโลก,12,4.11417E-05,38,0.000103995,50
ทา,32,0.000104437,55,0.000149327,87
ท่า,130,0.000414582,38,0.000103995,168
ท้า,11,3.7977E-05,0,2.66655E-06,11
ทางการ,0,3.16475E-06,26,7.19967E-05,26
ทางการแพทย์,0,3.16475E-06,29,7.99964E-05,29
ทางการเมือง,0,3.16475E-06,43,0.000117328,43
ทางทหาร,0,3.16475E-06,20,5.59975E-05,20
ทางสังคม,0,3.16475E-06,12,3.46651E-05,12
ทางออก,12,4.11417E-05,21,5.8664E-05,33
ทางอากาศ,0,3.16475E-06,56,0.000151993,56
ทาน,59,0.000189885,0,2.66655E-06,59
ท่าน,81,0.000259509,490,0.001309274,571
ทานข้าว,15,5.0636E-05,0,2.66655E-06,15
ท้าย,10,3.48122E-05,0,2.66655E-06,10
ทาส,22,7.27892E-05,10,2.9332E-05,32
ทำ,732,0.00231976,1035,0.002762541,1767
ทำการ,0,3.16475E-06,70,0.000189325,70
ทำกิจกรรม,0,3.16475E-06,32,8.7996E-05,32
ทำความสะอาด,0,3.16475E-06,96,0.000258655,96
ทำงาน,160,0.000509524,119,0.000319985,279
ทำใจ,12,4.11417E-05,0,2.66655E-06,12
ทำดี,15,5.0636E-05,35,9.59956E-05,50
ทำได้,60,0.00019305,65,0.000175992,125
ทำตัว,22,7.27892E-05,21,5.8664E-05,43
ทำตาม,11,3.7977E-05,25,6.93302E-05,36
ทำเนียบรัฐบาล,0,3.16475E-06,12,3.46651E-05,12
ทำเนียบฯ,0,3.16475E-06,13,3.73316E-05,13
ทำบุญ,36,0.000117096,37,0.000101329,73
ทำประโยชน์,0,3.16475E-06,18,5.06644E-05,18
ทำเป็น,17,5.69655E-05,0,2.66655E-06,17
ทำผิด,0,3.16475E-06,32,8.7996E-05,32
ทำผิดกฎหมาย,0,3.16475E-06,17,4.79978E-05,17
ทำร้าย,19,6.32949E-05,16,4.53313E-05,35
ทำลาย,11,3.7977E-05,53,0.000143993,64
ทำหน้าที่,0,3.16475E-06,86,0.000231989,86
ทำให้เกิด,0,3.16475E-06,19,5.33309E-05,19
ทิ,10,3.48122E-05,0,2.66655E-06,10
ทิ้ง,37,0.00012026,101,0.000271988,138
ทิต,10,3.48122E-05,0,2.66655E-06,10
ทิน,0,3.16475E-06,12,3.46651E-05,12
ทิพย์,16,5.38007E-05,20,5.59975E-05,36
ที้,0,3.16475E-06,10,2.9332E-05,10
ที่เกิด,0,3.16475E-06,30,8.26629E-05,30
ที่จอดรถ,14,4.74712E-05,0,2.66655E-06,14
ที่จะ,80,0.000256345,173,0.000463979,253
ที่เชื่อถือได้,0,3.16475E-06,12,3.46651E-05,12
ที่ดิน,0,3.16475E-06,34,9.33291E-05,34
ที่ทำงาน,12,4.11417E-05,25,6.93302E-05,37
ที่นั่ง,13,4.43065E-05,0,2.66655E-06,13
ทีนี้,0,3.16475E-06,14,3.99982E-05,14
ที่นี่,51,0.000164567,24,6.66636E-05,75
ที่ประชุม,0,3.16475E-06,17,4.79978E-05,17
ที่ผ่านมา,22,7.27892E-05,44,0.000119995,66
ที่พัก,18,6.01302E-05,0,2.66655E-06,18
ที่พึ่ง,0,3.16475E-06,314,0.000839962,314
ทีม,115,0.000367111,162,0.000434647,277
ทีมงาน,14,4.74712E-05,18,5.06644E-05,32
ที่มา,59,0.000189885,59,0.000159993,118
ที่รัก,46,0.000148743,28,7.73298E-05,74
ทีวี,13,4.43065E-05,26,7.19967E-05,39
ที่สูง,0,3.16475E-06,14,3.99982E-05,14
ที่อยู่,25,8.22834E-05,51,0.00013866,76
ทึ,12,4.11417E-05,0,2.66655E-06,12
ทุ,22,7.27892E-05,29,7.99964E-05,51
ทุกครั้งที่,18,6.01302E-05,0,2.66655E-06,18
ทุกท่าน,36,0.000117096,163,0.000437314,199
ทุกปี,15,5.0636E-05,0,2.66655E-06,15
ทุกฝ่าย,0,3.16475E-06,85,0.000229323,85
ทุ่ง,28,9.17777E-05,19,5.33309E-05,47
ทุ่งสง,18,6.01302E-05,0,2.66655E-06,18
ทุจริต,0,3.16475E-06,19,5.33309E-05,19
ทุนการศึกษา,0,3.16475E-06,11,3.19985E-05,11
ทุ่ม,39,0.00012659,0,2.66655E-06,39
ทุ่มเท,0,3.16475E-06,17,4.79978E-05,17
ทุเรศ,0,3.16475E-06,16,4.53313E-05,16
ทู,21,6.96244E-05,14,3.99982E-05,35
เท,164,0.000522183,46,0.000125328,210
เท่,26,8.54482E-05,19,5.33309E-05,45
เทคโนโลยี,0,3.16475E-06,23,6.39971E-05,23
เท็จ,0,3.16475E-06,30,8.26629E-05,30
เทป,17,5.69655E-05,0,2.66655E-06,17
เทพ,42,0.000136084,14,3.99982E-05,56
เทพย,0,3.16475E-06,33,9.06626E-05,33
เทรนด์,0,3.16475E-06,10,2.9332E-05,10
เทศกาล,15,5.0636E-05,26,7.19967E-05,41
เทศบาล,0,3.16475E-06,51,0.00013866,51
เท่ห์,13,4.43065E-05,0,2.66655E-06,13
เทอม,27,8.86129E-05,0,2.66655E-06,27
เทอร์มินอล,0,3.16475E-06,39,0.000106662,39
เทา,14,4.74712E-05,0,2.66655E-06,14
เท้า,15,5.0636E-05,12,3.46651E-05,27
เที่ยง,36,0.000117096,0,2.66655E-06,36
เที่ยงคืน,15,5.0636E-05,0,2.66655E-06,15
เทียน,25,8.22834E-05,15,4.26647E-05,40
เทียบ,0,3.16475E-06,14,3.99982E-05,14
เทียบท่า,0,3.16475E-06,33,9.06626E-05,33
เที่ยว,191,0.000607631,31,8.53295E-05,222
เที่ยวบิน,0,3.16475E-06,16,4.53313E-05,16
แท,14,4.74712E-05,0,2.66655E-06,14
แท็ก,42,0.000136084,0,2.66655E-06,42
แท็กซี่,0,3.16475E-06,12,3.46651E-05,12
แท็กทีม,0,3.16475E-06,38,0.000103995,38
แท่ง,0,3.16475E-06,35,9.59956E-05,35
แทน,79,0.00025318,97,0.000261321,176
แทบ,31,0.000101272,0,2.66655E-06,31
โท,32,0.000104437,12,3.46651E-05,44
โทด,11,3.7977E-05,0,2.66655E-06,11
โทน,13,4.43065E-05,0,2.66655E-06,13
โทร,147,0.000468383,16,4.53313E-05,163
โทรศัพท์,25,8.22834E-05,17,4.79978E-05,42
โทษ,11,3.7977E-05,65,0.000175992,76
ไท,31,0.000101272,0,2.66655E-06,31
ไทม์,14,4.74712E-05,0,2.66655E-06,14
ไทย,328,0.001041202,1164,0.003106526,1492
ไทยรัฐ,0,3.16475E-06,18,5.06644E-05,18
ไทยแลนด์,13,4.43065E-05,0,2.66655E-06,13
ธ,20,6.64597E-05,26,7.19967E-05,46
ธ.,20,6.64597E-05,66,0.000178659,86
ธ…,0,3.16475E-06,13,3.73316E-05,13
ธค,18,6.01302E-05,0,2.66655E-06,18
ธงชาติไทย,0,3.16475E-06,17,4.79978E-05,17
ธน,17,5.69655E-05,0,2.66655E-06,17
ธนา,10,3.48122E-05,259,0.000693302,269
ธนาคาร,0,3.16475E-06,13,3.73316E-05,13
ธร,12,4.11417E-05,278,0.000743966,290
ธรรม,40,0.000129755,25,6.93302E-05,65
ธรรมชาติ,34,0.000110766,26,7.19967E-05,60
ธรรมดา,14,4.74712E-05,15,4.26647E-05,29
ธวัช,0,3.16475E-06,25,6.93302E-05,25
ธัญ,0,3.16475E-06,46,0.000125328,46
ธันวา,78,0.000250015,0,2.66655E-06,78
ธาร,0,3.16475E-06,10,2.9332E-05,10
ธิ,0,3.16475E-06,13,3.73316E-05,13
ธิเบศร,19,6.32949E-05,0,2.66655E-06,19
ธิป,0,3.16475E-06,27,7.46633E-05,27
ธีร,0,3.16475E-06,18,5.06644E-05,18
ธุรกิจ,16,5.38007E-05,76,0.000205324,92
น์,14,4.74712E-05,0,2.66655E-06,14
น,448,0.001420972,187,0.000501311,635
"น""",16,5.38007E-05,0,2.66655E-06,16
น.,206,0.000655103,314,0.000839962,520
น.ส.,0,3.16475E-06,18,5.06644E-05,18
"น…""",0,3.16475E-06,14,3.99982E-05,14
นก,45,0.000145578,38,0.000103995,83
นค,12,4.11417E-05,14,3.99982E-05,26
นคร,41,0.000132919,0,2.66655E-06,41
นครนายก,11,3.7977E-05,104,0.000279987,115
นครปฐม,31,0.000101272,20,5.59975E-05,51
นครพนม,11,3.7977E-05,133,0.000357317,144
นครราชสีมา,10,3.48122E-05,147,0.000394649,157
นครศรีธรรมราช,37,0.00012026,34,9.33291E-05,71
นครสวรรค์,30,9.81072E-05,0,2.66655E-06,30
นคะ,11,3.7977E-05,20,5.59975E-05,31
นท,44,0.000142414,42,0.000114661,86
นทิ,0,3.16475E-06,27,7.46633E-05,27
นน,60,0.00019305,0,2.66655E-06,60
นน.,13,4.43065E-05,0,2.66655E-06,13
นนท์,42,0.000136084,11,3.19985E-05,53
นนทบุรี,32,0.000104437,0,2.66655E-06,32
นนน,59,0.000189885,0,2.66655E-06,59
นนนน,25,8.22834E-05,0,2.66655E-06,25
นนนนน,14,4.74712E-05,0,2.66655E-06,14
นฝ.,0,3.16475E-06,23,6.39971E-05,23
นพ,20,6.64597E-05,0,2.66655E-06,20
นม,106,0.000338628,12,3.46651E-05,118
นย,0,3.16475E-06,10,2.9332E-05,10
นโยบาย,0,3.16475E-06,72,0.000194658,72
นรก,0,3.16475E-06,17,4.79978E-05,17
นราธิวาส,0,3.16475E-06,36,9.86622E-05,36
นรินทร์,12,4.11417E-05,0,2.66655E-06,12
นเรศวร,0,3.16475E-06,17,4.79978E-05,17
นว,10,3.48122E-05,0,2.66655E-06,10
นวด,824,0.002610916,0,2.66655E-06,824
นวมินทร์,18,6.01302E-05,0,2.66655E-06,18
นวล,0,3.16475E-06,30,8.26629E-05,30
นศ.,10,3.48122E-05,0,2.66655E-06,10
นศท.,0,3.16475E-06,52,0.000141327,52
นอ,55,0.000177226,29,7.99964E-05,84
น้อ,11,3.7977E-05,19,5.33309E-05,30
น้อง,1083,0.003430586,243,0.000650637,1326
น้องสาว,12,4.11417E-05,0,2.66655E-06,12
น้องๆ,54,0.000174061,61,0.000165326,115
นอน,311,0.000987401,44,0.000119995,355
น้อน,56,0.000180391,0,2.66655E-06,56
น้อม,48,0.000155073,22,6.13306E-05,70
น้อยใจ,11,3.7977E-05,0,2.66655E-06,11
น้อยลง,10,3.48122E-05,0,2.66655E-06,10
น้อล,11,3.7977E-05,0,2.66655E-06,11
นะคะ,805,0.002550786,376,0.001005288,1181
นะค้า,14,4.74712E-05,0,2.66655E-06,14
นะจ๊ะ,28,9.17777E-05,19,5.33309E-05,47
นะเนี่ย,13,4.43065E-05,0,2.66655E-06,13
นักการเมือง,0,3.16475E-06,83,0.00022399,83
นักกีฬา,0,3.16475E-06,12,3.46651E-05,12
นักข่าว,10,3.48122E-05,41,0.000111995,51
นักท่องเที่ยว,0,3.16475E-06,36,9.86622E-05,36
นักโทษ,0,3.16475E-06,24,6.66636E-05,24
นักบิน,0,3.16475E-06,11,3.19985E-05,11
นักรบ,0,3.16475E-06,14,3.99982E-05,14
นักเรียน,24,7.91187E-05,96,0.000258655,120
นักศึกษา,116,0.000370275,25,6.93302E-05,141
นักศึกษาวิชาทหาร,0,3.16475E-06,16,4.53313E-05,16
นักแสดง,18,6.01302E-05,0,2.66655E-06,18
นัง,19,6.32949E-05,0,2.66655E-06,19
นั่ง,214,0.000680421,73,0.000197324,287
นั้ง,10,3.48122E-05,0,2.66655E-06,10
นัด,1056,0.003345138,47,0.000127994,1103
นัต”,0,3.16475E-06,12,3.46651E-05,12
นัท,14,4.74712E-05,0,2.66655E-06,14
นั่นสิ,12,4.11417E-05,0,2.66655E-06,12
นั้นแหละ,22,7.27892E-05,29,7.99964E-05,51
นัย,13,4.43065E-05,10,2.9332E-05,23
นั้ย,0,3.16475E-06,13,3.73316E-05,13
นัว,28,9.17777E-05,0,2.66655E-06,28
นา,112,0.000357616,491,0.001311941,603
น้า,237,0.00075321,12,3.46651E-05,249
น๊า,16,5.38007E-05,0,2.66655E-06,16
น้ํา,24,7.91187E-05,0,2.66655E-06,24
นํ้า,12,4.11417E-05,0,2.66655E-06,12
น่ากลัว,31,0.000101272,28,7.73298E-05,59
น่ากิน,19,6.32949E-05,0,2.66655E-06,19
นาค,0,3.16475E-06,48,0.000130661,48
นางฟ้า,11,3.7977E-05,0,2.66655E-06,11
น่าชื่นชม,0,3.16475E-06,16,4.53313E-05,16
น่าดู,12,4.11417E-05,0,2.66655E-06,12
นาถ,25,8.22834E-05,0,2.66655E-06,25
นาที,46,0.000148743,26,7.19967E-05,72
น่าน,33,0.000107601,15,4.26647E-05,48
นานาชาติ,12,4.11417E-05,0,2.66655E-06,12
นาบ,34,0.000110766,0,2.66655E-06,34
นาม,0,3.16475E-06,41,0.000111995,41
นายก,10,3.48122E-05,118,0.000317319,128
นายกรัฐมนตรี,0,3.16475E-06,65,0.000175992,65
นายกฯ,0,3.16475E-06,218,0.000583974,218
นายทหาร,0,3.16475E-06,24,6.66636E-05,24
นายทุน,0,3.16475E-06,10,2.9332E-05,10
นายแบบ,18,6.01302E-05,0,2.66655E-06,18
นายพล,0,3.16475E-06,48,0.000130661,48
นายร้อย,0,3.16475E-06,75,0.000202657,75
น่ารัก,750,0.002376725,42,0.000114661,792
นารี,0,3.16475E-06,10,2.9332E-05,10
น่ารู้,0,3.16475E-06,15,4.26647E-05,15
นาวิกโยธิน,0,3.16475E-06,17,4.79978E-05,17
น่าสงสาร,0,3.16475E-06,16,4.53313E-05,16
น่าสนใจ,11,3.7977E-05,24,6.66636E-05,35
น่าเสียดาย,0,3.16475E-06,13,3.73316E-05,13
น๊าาา,15,5.0636E-05,0,2.66655E-06,15
น้ำ,319,0.001012719,532,0.001421269,851
นำเข้า,0,3.16475E-06,17,4.79978E-05,17
น้ำใจ,0,3.16475E-06,22,6.13306E-05,22
น้ำดับไฟ,0,3.16475E-06,23,6.39971E-05,23
น้ำดิบ,0,3.16475E-06,19,5.33309E-05,19
น้ำตก,13,4.43065E-05,0,2.66655E-06,13
น้ำตา,43,0.000139249,80,0.00021599,123
น้ำตาล,10,3.48122E-05,0,2.66655E-06,10
น้ำตาไหล,14,4.74712E-05,0,2.66655E-06,14
น้ำท่วม,55,0.000177226,0,2.66655E-06,55
น้ำบาดาล,0,3.16475E-06,34,9.33291E-05,34
น้ำพริก,13,4.43065E-05,0,2.66655E-06,13
น้ำมัน,65,0.000208873,15,4.26647E-05,80
น้ำเย็น,13,4.43065E-05,0,2.66655E-06,13
น้ำลาย,18,6.01302E-05,0,2.66655E-06,18
นำเสนอ,0,3.16475E-06,13,3.73316E-05,13
น้ำหนัก,22,7.27892E-05,20,5.59975E-05,42
น้ำหอม,11,3.7977E-05,0,2.66655E-06,11
นิ,111,0.000354452,54,0.00014666,165
นิคม,36,0.000117096,0,2.66655E-06,36
นิ่ง,29,9.49424E-05,27,7.46633E-05,56
นิดเดียว,11,3.7977E-05,10,2.9332E-05,21
นิดนึง,24,7.91187E-05,0,2.66655E-06,24
นิติ,0,3.16475E-06,16,4.53313E-05,16
นินทา,12,4.11417E-05,0,2.66655E-06,12
นิ่ม,10,3.48122E-05,0,2.66655E-06,10
นิยาย,11,3.7977E-05,0,2.66655E-06,11
นิรนาม,0,3.16475E-06,11,3.19985E-05,11
นิรันดร์,40,0.000129755,0,2.66655E-06,40
นิว,34,0.000110766,33,9.06626E-05,67
นิ้ว,18,6.01302E-05,0,2.66655E-06,18
นิวส์,0,3.16475E-06,164,0.00043998,164
นิสัย,25,8.22834E-05,12,3.46651E-05,37
นี,11,3.7977E-05,13,3.73316E-05,24
นีเซีย,0,3.16475E-06,11,3.19985E-05,11
นี้แหละ,34,0.000110766,42,0.000114661,76
นึก,64,0.000205709,24,6.66636E-05,88
นึกถึง,21,6.96244E-05,23,6.39971E-05,44
นึง,146,0.000465218,32,8.7996E-05,178
นุ,32,0.000104437,12,3.46651E-05,44
นุช,97,0.000310145,0,2.66655E-06,97
นุ่ม,28,9.17777E-05,0,2.66655E-06,28
นู,10,3.48122E-05,0,2.66655E-06,10
นู๋,22,7.27892E-05,0,2.66655E-06,22
นๆ,15,5.0636E-05,0,2.66655E-06,15
เน,11,3.7977E-05,0,2.66655E-06,11
เน่,12,4.11417E-05,0,2.66655E-06,12
เนชั่น,0,3.16475E-06,27,7.46633E-05,27
เน็ต,12,4.11417E-05,19,5.33309E-05,31
เนย,21,6.96244E-05,0,2.66655E-06,21
เนรคุณ,0,3.16475E-06,10,2.9332E-05,10
เนอ,13,4.43065E-05,0,2.66655E-06,13
เน้อ,19,6.32949E-05,0,2.66655E-06,19
เนอะ,89,0.000284827,38,0.000103995,127
เน่า,0,3.16475E-06,83,0.00022399,83
เน่าเหม็น,0,3.16475E-06,27,7.46633E-05,27
เนาะ,55,0.000177226,28,7.73298E-05,83
เนี้ย,18,6.01302E-05,0,2.66655E-06,18
เนียน,24,7.91187E-05,16,4.53313E-05,40
"เนื่…""",0,3.16475E-06,10,2.9332E-05,10
เนื้อ,62,0.000199379,30,8.26629E-05,92
เนื่องใน,20,6.64597E-05,81,0.000218657,101
เนื้อหา,0,3.16475E-06,12,3.46651E-05,12
แน่,55,0.000177226,44,0.000119995,99
แน่ใจ,10,3.48122E-05,0,2.66655E-06,10
แน่น,49,0.000158237,20,5.59975E-05,69
แน่นอน,56,0.000180391,36,9.86622E-05,92
แนว,28,9.17777E-05,124,0.000333318,152
แนวคิด,0,3.16475E-06,25,6.93302E-05,25
แนวทาง,0,3.16475E-06,38,0.000103995,38
แนวโน้ม,0,3.16475E-06,11,3.19985E-05,11
แนะ,0,3.16475E-06,69,0.000186658,69
แนะนำ,57,0.000183555,38,0.000103995,95
แน่ๆ,62,0.000199379,25,6.93302E-05,87
โน,47,0.000151908,13,3.73316E-05,60
โน่,14,4.74712E-05,0,2.66655E-06,14
ในขณะที่,0,3.16475E-06,17,4.79978E-05,17
ในที่สุด,18,6.01302E-05,0,2.66655E-06,18
ในประเทศ,17,5.69655E-05,63,0.000170659,80
ในหลวง,46,0.000148743,75,0.000202657,121
ในอนาคต,0,3.16475E-06,42,0.000114661,42
บ,139,0.000443065,63,0.000170659,202
บ่,52,0.000167732,17,4.79978E-05,69
บ.,43,0.000139249,373,0.000997288,416
บ…,0,3.16475E-06,14,3.99982E-05,14
"บ…""",0,3.16475E-06,19,5.33309E-05,19
บก,0,3.16475E-06,11,3.19985E-05,11
บกพร่อง,0,3.16475E-06,16,4.53313E-05,16
บท,38,0.000123425,24,6.66636E-05,62
บทเรียน,0,3.16475E-06,31,8.53295E-05,31
บ่น,19,6.32949E-05,29,7.99964E-05,48
บบ,67,0.000215203,0,2.66655E-06,67
บบบ,31,0.000101272,0,2.66655E-06,31
บบบบ,14,4.74712E-05,0,2.66655E-06,14
บบบบบ,74,0.000237356,0,2.66655E-06,74
"บบบบบ""",10,3.48122E-05,0,2.66655E-06,10
บพิตร,24,7.91187E-05,0,2.66655E-06,24
บร,0,3.16475E-06,16,4.53313E-05,16
บรม,72,0.000231027,65,0.000175992,137
บรมราชาภิเษก,0,3.16475E-06,123,0.000330652,123
บรรทุก,0,3.16475E-06,67,0.000181325,67
บรรเทา,0,3.16475E-06,182,0.000487978,182
บรรพชา,0,3.16475E-06,30,8.26629E-05,30
บรรยากาศ,67,0.000215203,46,0.000125328,113
บริการ,164,0.000522183,36,9.86622E-05,200
บริจาค,45,0.000145578,271,0.0007253,316
บริเวณ,11,3.7977E-05,116,0.000311986,127
บริษัท,20,6.64597E-05,34,9.33291E-05,54
บริหาร,13,4.43065E-05,39,0.000106662,52
บล็อก,11,3.7977E-05,0,2.66655E-06,11
บล็อค,12,4.11417E-05,0,2.66655E-06,12
บวก,37,0.00012026,12,3.46651E-05,49
บวช,0,3.16475E-06,14,3.99982E-05,14
บห.,0,3.16475E-06,11,3.19985E-05,11
บอ,192,0.000610796,99,0.000266655,291
บ่อ,28,9.17777E-05,118,0.000317319,146
บอกต่อ,64,0.000205709,0,2.66655E-06,64
บอน,34,0.000110766,0,2.66655E-06,34
บอย,14,4.74712E-05,0,2.66655E-06,14
บอร์ด,0,3.16475E-06,13,3.73316E-05,13
บอล,21,6.96244E-05,20,5.59975E-05,41
บ่อวิน,17,5.69655E-05,0,2.66655E-06,17
บอส,18,6.01302E-05,0,2.66655E-06,18
บั…,0,3.16475E-06,11,3.19985E-05,11
"บั…""",0,3.16475E-06,10,2.9332E-05,10
บัก,11,3.7977E-05,0,2.66655E-06,11
บัง,61,0.000196214,0,2.66655E-06,61
บังคับ,16,5.38007E-05,46,0.000125328,62
บังเอิญ,10,3.48122E-05,0,2.66655E-06,10
บัญชา,0,3.16475E-06,12,3.46651E-05,12
บัญชาการ,0,3.16475E-06,10,2.9332E-05,10
บัญชี,13,4.43065E-05,0,2.66655E-06,13
บัตร,86,0.000275333,53,0.000143993,139
บันทึก,12,4.11417E-05,20,5.59975E-05,32
บั้ม,20,6.64597E-05,0,2.66655E-06,20
บัว,29,9.49424E-05,17,4.79978E-05,46
บา,14,4.74712E-05,0,2.66655E-06,14
บ้า,46,0.000148743,30,8.26629E-05,76
บางคน,42,0.000136084,53,0.000143993,95
บางแค,22,7.27892E-05,0,2.66655E-06,22
บางนา,66,0.000212038,0,2.66655E-06,66
บางระจัน,0,3.16475E-06,10,2.9332E-05,10
บางส่วน,0,3.16475E-06,17,4.79978E-05,17
บาด,0,3.16475E-06,18,5.06644E-05,18
บาดเจ็บ,0,3.16475E-06,75,0.000202657,75
บาดาล,0,3.16475E-06,153,0.000410648,153
บาท,219,0.000696244,169,0.000453313,388
บาน,14,4.74712E-05,0,2.66655E-06,14
บ้าน,485,0.001538067,531,0.001418602,1016
บ้านเกิด,0,3.16475E-06,14,3.99982E-05,14
บ้านพัก,0,3.16475E-06,31,8.53295E-05,31
บ้านโพธิ์,10,3.48122E-05,0,2.66655E-06,10
บ้านเมือง,0,3.16475E-06,121,0.000325319,121
บ้านเรือน,0,3.16475E-06,28,7.73298E-05,28
บ้าบอ,12,4.11417E-05,0,2.66655E-06,12
บาย,11,3.7977E-05,0,2.66655E-06,11
บ่าย,49,0.000158237,47,0.000127994,96
บารมี,0,3.16475E-06,16,4.53313E-05,16
บาส,45,0.000145578,0,2.66655E-06,45
บำเพ็ญ,0,3.16475E-06,10,2.9332E-05,10
บำเพ็ญกุศล,0,3.16475E-06,44,0.000119995,44
บำรุง,18,6.01302E-05,23,6.39971E-05,41
บิ,35,0.000113931,0,2.66655E-06,35
บิ๊ก,49,0.000158237,528,0.001410603,577
บิดเบือน,0,3.16475E-06,142,0.000381316,142
บิดา,0,3.16475E-06,11,3.19985E-05,11
บิน,65,0.000208873,182,0.000487978,247
บิล,10,3.48122E-05,0,2.66655E-06,10
บี,44,0.000142414,24,6.66636E-05,68
บี้,11,3.7977E-05,0,2.66655E-06,11
บีบ,12,4.11417E-05,0,2.66655E-06,12
บึง,73,0.000234191,0,2.66655E-06,73
บุ,22,7.27892E-05,52,0.000141327,74
บุก,0,3.16475E-06,32,8.7996E-05,32
บุ๊ค,0,3.16475E-06,10,2.9332E-05,10
บุคคล,10,3.48122E-05,75,0.000202657,85
บุคลากร,0,3.16475E-06,32,8.7996E-05,32
บุญ,39,0.00012659,31,8.53295E-05,70
บุตร,0,3.16475E-06,113,0.000303986,113
บุตรหลาน,0,3.16475E-06,23,6.39971E-05,23
บุ๋น,19,6.32949E-05,0,2.66655E-06,19
บุรี,38,0.000123425,0,2.66655E-06,38
บุรีรัมย์,39,0.00012659,38,0.000103995,77
บูชา,10,3.48122E-05,0,2.66655E-06,10
บูด,0,3.16475E-06,44,0.000119995,44
บูธ,19,6.32949E-05,0,2.66655E-06,19
บูรณาการ,0,3.16475E-06,18,5.06644E-05,18
เบล,17,5.69655E-05,0,2.66655E-06,17
เบอ,11,3.7977E-05,0,2.66655E-06,11
เบอร์,70,0.000224697,0,2.66655E-06,70
เบา,85,0.000272168,0,2.66655E-06,85
เบียร์,30,9.81072E-05,0,2.66655E-06,30
เบียว,11,3.7977E-05,0,2.66655E-06,11
เบื่อ,108,0.000344957,67,0.000181325,175
เบื้องต้น,0,3.16475E-06,43,0.000117328,43
เบื้องหลัง,12,4.11417E-05,0,2.66655E-06,12
แบ,227,0.000721562,0,2.66655E-06,227
แบก,10,3.48122E-05,40,0.000109328,50
แบ่ง,21,6.96244E-05,14,3.99982E-05,35
แบงค์,14,4.74712E-05,0,2.66655E-06,14
แบ่งปัน,0,3.16475E-06,13,3.73316E-05,13
แบต,11,3.7977E-05,0,2.66655E-06,11
แบตเตอรี่,14,4.74712E-05,0,2.66655E-06,14
แบน,20,6.64597E-05,0,2.66655E-06,20
แบบนี้,358,0.001136144,462,0.001234611,820
แบบอย่าง,0,3.16475E-06,15,4.26647E-05,15
แบรนด์,24,7.91187E-05,0,2.66655E-06,24
แบริ่ง,36,0.000117096,0,2.66655E-06,36
โบ,28,9.17777E-05,0,2.66655E-06,28
โบราณ,0,3.16475E-06,42,0.000114661,42
ใบ,138,0.0004399,17,4.79978E-05,155
ใบแดง,0,3.16475E-06,24,6.66636E-05,24
ใบประกาศ,0,3.16475E-06,30,8.26629E-05,30
ไบ,24,7.91187E-05,0,2.66655E-06,24
ไบ๊,18,6.01302E-05,0,2.66655E-06,18
ไบร์,14,4.74712E-05,0,2.66655E-06,14
ไบร์ท,75,0.000240521,0,2.66655E-06,75
ป,99,0.000316475,38,0.000103995,137
ป.,22,7.27892E-05,100,0.000269321,122
ป.ป.ช.,0,3.16475E-06,11,3.19985E-05,11
ป…,0,3.16475E-06,26,7.19967E-05,26
"ป…""",0,3.16475E-06,24,6.66636E-05,24
ปก,87,0.000278498,0,2.66655E-06,87
ปกครอง,0,3.16475E-06,19,5.33309E-05,19
ปกติ,68,0.000218368,47,0.000127994,115
ปกป้อง,12,4.11417E-05,53,0.000143993,65
ปชช,0,3.16475E-06,10,2.9332E-05,10
ปชช.,0,3.16475E-06,82,0.000221323,82
ปชต.,0,3.16475E-06,21,5.8664E-05,21
ปชป.,0,3.16475E-06,11,3.19985E-05,11
ปฎิรูป,0,3.16475E-06,11,3.19985E-05,11
ปฏิ,0,3.16475E-06,22,6.13306E-05,22
ปฏิบัติการ,0,3.16475E-06,96,0.000258655,96
ปฏิบัติงาน,0,3.16475E-06,44,0.000119995,44
ปฏิบัติธรรม,0,3.16475E-06,10,2.9332E-05,10
ปฏิบัติภารกิจ,0,3.16475E-06,16,4.53313E-05,16
ปฏิบัติหน้าที่,0,3.16475E-06,52,0.000141327,52
ปฏิรูป,0,3.16475E-06,67,0.000181325,67
ปท.,0,3.16475E-06,22,6.13306E-05,22
ปทุมธานี,17,5.69655E-05,0,2.66655E-06,17
ปภ.,0,3.16475E-06,48,0.000130661,48
ปม,0,3.16475E-06,74,0.000199991,74
ปร,0,3.16475E-06,12,3.46651E-05,12
ประ,28,9.17777E-05,165,0.000442647,193
ประกาศ,47,0.000151908,188,0.000503977,235
ประคอง,0,3.16475E-06,23,6.39971E-05,23
ประจวบ,14,4.74712E-05,0,2.66655E-06,14
ประจำ,31,0.000101272,48,0.000130661,79
ประจำปี,0,3.16475E-06,56,0.000151993,56
ประชา,25,8.22834E-05,75,0.000202657,100
ประชาชน,52,0.000167732,1923,0.005130434,1975
ประชาธิปไตย,0,3.16475E-06,120,0.000322652,120
ประชาธิปัตย์,0,3.16475E-06,16,4.53313E-05,16
ประชาสัมพันธ์,0,3.16475E-06,17,4.79978E-05,17
ประชุม,11,3.7977E-05,121,0.000325319,132
ประณาม,0,3.16475E-06,15,4.26647E-05,15
ประดับ,0,3.16475E-06,11,3.19985E-05,11
ประเด็น,13,4.43065E-05,77,0.000207991,90
ประตู,29,9.49424E-05,26,7.19967E-05,55
ประท้วง,0,3.16475E-06,11,3.19985E-05,11
ประทับใจ,25,8.22834E-05,17,4.79978E-05,42
ประเทศ,118,0.000376605,578,0.00154393,696
ประเทศชาติ,0,3.16475E-06,72,0.000194658,72
ประธาน,0,3.16475E-06,114,0.000306653,114
ประธานรัฐสภา,0,3.16475E-06,11,3.19985E-05,11
ประปา,0,3.16475E-06,14,3.99982E-05,14
ประเพณี,0,3.16475E-06,90,0.000242656,90
ประไพ,0,3.16475E-06,15,4.26647E-05,15
ประเภท,15,5.0636E-05,30,8.26629E-05,45
ประมาท,0,3.16475E-06,13,3.73316E-05,13
ประมุข,0,3.16475E-06,13,3.73316E-05,13
ประยุทธ์,0,3.16475E-06,99,0.000266655,99
ประโยค,14,4.74712E-05,11,3.19985E-05,25
ประโยชน์,0,3.16475E-06,49,0.000133327,49
ประวัติ,0,3.16475E-06,22,6.13306E-05,22
ประวัติศาสตร์,0,3.16475E-06,64,0.000173325,64
ประวิตร,0,3.16475E-06,13,3.73316E-05,13
ประสบการณ์,12,4.11417E-05,21,5.8664E-05,33
ประสบความสำเร็จ,11,3.7977E-05,0,2.66655E-06,11
ประสบภัย,0,3.16475E-06,28,7.73298E-05,28
ประสาท,27,8.86129E-05,0,2.66655E-06,27
ประสาน,0,3.16475E-06,16,4.53313E-05,16
ประสิทธิ์,0,3.16475E-06,16,4.53313E-05,16
ประหลาด,0,3.16475E-06,11,3.19985E-05,11
ปรับปรุง,0,3.16475E-06,43,0.000117328,43
ปราการ,0,3.16475E-06,18,5.06644E-05,18
ปราจีนบุรี,0,3.16475E-06,12,3.46651E-05,12
ปราณ,14,4.74712E-05,0,2.66655E-06,14
ปราบ,0,3.16475E-06,23,6.39971E-05,23
ปราบปราม,0,3.16475E-06,10,2.9332E-05,10
ปราศรัย,0,3.16475E-06,10,2.9332E-05,10
ปริมาณ,0,3.16475E-06,21,5.8664E-05,21
ปรือ,23,7.59539E-05,0,2.66655E-06,23
ปล.,28,9.17777E-05,0,2.66655E-06,28
ปลด,0,3.16475E-06,26,7.19967E-05,26
ปล้น,0,3.16475E-06,138,0.00037065,138
ปลวก,27,8.86129E-05,0,2.66655E-06,27
ปลอ…,0,3.16475E-06,14,3.99982E-05,14
ปลอดภัย,35,0.000113931,192,0.000514643,227
ปลอม,22,7.27892E-05,186,0.000498644,208
ปล่อย,66,0.000212038,98,0.000263988,164
ปล่อยข่าว,0,3.16475E-06,17,4.79978E-05,17
ปลัด,0,3.16475E-06,27,7.46633E-05,27
ปลา,73,0.000234191,13,3.73316E-05,86
ปลาย,21,6.96244E-05,0,2.66655E-06,21
ปลื้ม,14,4.74712E-05,13,3.73316E-05,27
ปลุก,10,3.48122E-05,20,5.59975E-05,30
ปลุกปั่น,0,3.16475E-06,25,6.93302E-05,25
ปลุกระดม,0,3.16475E-06,30,8.26629E-05,30
ปลูก,0,3.16475E-06,36,9.86622E-05,36
ปวด,47,0.000151908,0,2.66655E-06,47
ปวดท้อง,13,4.43065E-05,0,2.66655E-06,13
ปวดหลัง,16,5.38007E-05,0,2.66655E-06,16
ปวดหัว,23,7.59539E-05,0,2.66655E-06,23
ป่วน,0,3.16475E-06,20,5.59975E-05,20
ป่วย,17,5.69655E-05,28,7.73298E-05,45
ป๋อ,17,5.69655E-05,0,2.66655E-06,17
ป๊อก,0,3.16475E-06,15,4.26647E-05,15
ปอง,0,3.16475E-06,12,3.46651E-05,12
ป้อง,0,3.16475E-06,46,0.000125328,46
ป้องกัน,15,5.0636E-05,400,0.001069285,415
ปอด,0,3.16475E-06,24,6.66636E-05,24
ป๊อป,0,3.16475E-06,38,0.000103995,38
ป้อม,0,3.16475E-06,63,0.000170659,63
ปอย,14,4.74712E-05,0,2.66655E-06,14
ปะ,99,0.000316475,26,7.19967E-05,125
ป่ะ,95,0.000303816,0,2.66655E-06,95
ปะทะ,0,3.16475E-06,57,0.00015466,57
ปะทุ,0,3.16475E-06,34,9.33291E-05,34
ปัก,18,6.01302E-05,0,2.66655E-06,18
ปัง,89,0.000284827,31,8.53295E-05,120
ปัญญา,0,3.16475E-06,16,4.53313E-05,16
ปัญญาอ่อน,0,3.16475E-06,10,2.9332E-05,10
ปัญหา,30,9.81072E-05,169,0.000453313,199
ปัด,10,3.48122E-05,24,6.66636E-05,34
ปัตตานี,33,0.000107601,13,3.73316E-05,46
ปัน,0,3.16475E-06,10,2.9332E-05,10
ปั่น,48,0.000155073,74,0.000199991,122
ปั่นป่วน,0,3.16475E-06,11,3.19985E-05,11
ปั้ม,13,4.43065E-05,0,2.66655E-06,13
ปา,32,0.000104437,54,0.00014666,86
ป่า,39,0.00012659,91,0.000245322,130
ป้า,60,0.00019305,41,0.000111995,101
ป๊า,42,0.000136084,0,2.66655E-06,42
ป๋า,22,7.27892E-05,10,2.9332E-05,32
ปาก,138,0.0004399,76,0.000205324,214
ปากน้ำ,15,5.0636E-05,0,2.66655E-06,15
ปากหมา,0,3.16475E-06,13,3.73316E-05,13
ปาง,0,3.16475E-06,12,3.46651E-05,12
ป่าชุมชน,0,3.16475E-06,31,8.53295E-05,31
ป่าตอง,15,5.0636E-05,0,2.66655E-06,15
ปาย,14,4.74712E-05,0,2.66655E-06,14
ป้าย,63,0.000202544,41,0.000111995,104
ปาร์ค,11,3.7977E-05,0,2.66655E-06,11
ปาร์ตี้,16,5.38007E-05,0,2.66655E-06,16
ป่าว,74,0.000237356,35,9.59956E-05,109
ป่าสงวน,0,3.16475E-06,12,3.46651E-05,12
ปิ่…,0,3.16475E-06,10,2.9332E-05,10
ปิ้ง,34,0.000110766,0,2.66655E-06,34
ปิดบัง,0,3.16475E-06,11,3.19985E-05,11
ปิ่น,12,4.11417E-05,0,2.66655E-06,12
ปิย,0,3.16475E-06,106,0.00028532,106
ปิยะ,0,3.16475E-06,16,4.53313E-05,16
ปี,354,0.001123485,382,0.001021287,736
ปี้,0,3.16475E-06,36,9.86622E-05,36
ปีติ,0,3.16475E-06,12,3.46651E-05,12
ปีหน้า,37,0.00012026,0,2.66655E-06,37
ปีใหม่,45,0.000145578,89,0.000239989,134
ปืน,0,3.16475E-06,62,0.000167992,62
ปืนใหญ่,0,3.16475E-06,11,3.19985E-05,11
ปุ,13,4.43065E-05,0,2.66655E-06,13
ปุก,0,3.16475E-06,16,4.53313E-05,16
ปุ๊บ,12,4.11417E-05,0,2.66655E-06,12
ปุ่ม,14,4.74712E-05,0,2.66655E-06,14
ปู,47,0.000151908,16,4.53313E-05,63
ปู่,10,3.48122E-05,13,3.73316E-05,23
ปู๋,10,3.48122E-05,0,2.66655E-06,10
ปูเค็ม,0,3.16475E-06,17,4.79978E-05,17
ปู่เจ้า,12,4.11417E-05,0,2.66655E-06,12
ปฺฎิบัติ,0,3.16475E-06,15,4.26647E-05,15
เป,15,5.0636E-05,0,2.66655E-06,15
เป้,12,4.11417E-05,85,0.000229323,97
เป็…,0,3.16475E-06,23,6.39971E-05,23
เป๊ก,84,0.000269004,0,2.66655E-06,84
เปง,27,8.86129E-05,0,2.66655E-06,27
เป็ด,19,6.32949E-05,0,2.66655E-06,19
เปน,62,0.000199379,20,5.59975E-05,82
เป็นกันเอง,40,0.000129755,0,2.66655E-06,40
เป็นกำลัง,0,3.16475E-06,27,7.46633E-05,27
เป็นเกียรติ,0,3.16475E-06,15,4.26647E-05,15
เป็นข่าว,0,3.16475E-06,25,6.93302E-05,25
เป็นไง,15,5.0636E-05,0,2.66655E-06,15
เป็นได้,0,3.16475E-06,10,2.9332E-05,10
เป็นตัว,10,3.48122E-05,0,2.66655E-06,10
เป็นทางการ,0,3.16475E-06,17,4.79978E-05,17
เป็นธรรม,0,3.16475E-06,14,3.99982E-05,14
เป็นแนว,0,3.16475E-06,18,5.06644E-05,18
เป็นประโยชน์,0,3.16475E-06,13,3.73316E-05,13
เป็นปัญหา,0,3.16475E-06,18,5.06644E-05,18
เป็นไป,0,3.16475E-06,27,7.46633E-05,27
เป็นไปตาม,0,3.16475E-06,13,3.73316E-05,13
เป็นผล,0,3.16475E-06,17,4.79978E-05,17
เป็นผู้แทน,0,3.16475E-06,36,9.86622E-05,36
เป็นพิเศษ,10,3.48122E-05,0,2.66655E-06,10
เป็นเพื่อน,28,9.17777E-05,0,2.66655E-06,28
เป็นระบบ,0,3.16475E-06,24,6.66636E-05,24
เป็นเรื่อง,0,3.16475E-06,98,0.000263988,98
เป็นโรค,11,3.7977E-05,0,2.66655E-06,11
เป็นหนึ่ง,0,3.16475E-06,17,4.79978E-05,17
เป็นหลัก,0,3.16475E-06,13,3.73316E-05,13
เป็นห่วง,14,4.74712E-05,32,8.7996E-05,46
เปย์,16,5.38007E-05,0,2.66655E-06,16
เปรียบเทียบ,0,3.16475E-06,10,2.9332E-05,10
เปรี้ยว,20,6.64597E-05,0,2.66655E-06,20
เปล่า,23,7.59539E-05,10,2.9332E-05,33
เปลี่ยนไป,15,5.0636E-05,10,2.9332E-05,25
เปอร์,11,3.7977E-05,0,2.66655E-06,11
เป่า,30,9.81072E-05,0,2.66655E-06,30
เป๋า,18,6.01302E-05,0,2.66655E-06,18
เป้าหมาย,0,3.16475E-06,17,4.79978E-05,17
เปิดกล้อง,41,0.000132919,0,2.66655E-06,41
เปิดงาน,0,3.16475E-06,14,3.99982E-05,14
เปิดใจ,0,3.16475E-06,11,3.19985E-05,11
เปิดตัว,0,3.16475E-06,37,0.000101329,37
แป,29,9.49424E-05,0,2.66655E-06,29
แป้ง,23,7.59539E-05,0,2.66655E-06,23
แปด,15,5.0636E-05,0,2.66655E-06,15
แป๊บ,11,3.7977E-05,0,2.66655E-06,11
แปล,46,0.000148743,11,3.19985E-05,57
แปลก,30,9.81072E-05,21,5.8664E-05,51
แปลกใจ,11,3.7977E-05,0,2.66655E-06,11
แปลง,22,7.27892E-05,0,2.66655E-06,22
แปลงเพศ,24,7.91187E-05,0,2.66655E-06,24
แปลน,25,8.22834E-05,0,2.66655E-06,25
แปะ,16,5.38007E-05,0,2.66655E-06,16
แป๊ะ,0,3.16475E-06,14,3.99982E-05,14
โป,14,4.74712E-05,0,2.66655E-06,14
โป๊,33,0.000107601,0,2.66655E-06,33
โปร,94,0.000300651,0,2.66655E-06,94
โปร่งใส,0,3.16475E-06,15,4.26647E-05,15
โปรเจค,20,6.64597E-05,0,2.66655E-06,20
โปรด,21,6.96244E-05,11,3.19985E-05,32
โปรดเกล้าโปรดกระหม่อม,0,3.16475E-06,14,3.99982E-05,14
โปรดเกล้าฯ,0,3.16475E-06,73,0.000197324,73
โปรโมชั่น,26,8.54482E-05,0,2.66655E-06,26
โปรโมท,0,3.16475E-06,10,2.9332E-05,10
โปรย,0,3.16475E-06,37,0.000101329,37
โป๊ะ,12,4.11417E-05,0,2.66655E-06,12
โป๊ะแตก,0,3.16475E-06,16,4.53313E-05,16
ไปดู,125,0.000398758,32,8.7996E-05,157
ไปเที่ยว,69,0.000221532,13,3.73316E-05,82
ไปมา,19,6.32949E-05,0,2.66655E-06,19
ไปหา,119,0.00037977,14,3.99982E-05,133
"ผ่…""",0,3.16475E-06,15,4.26647E-05,15
ผช,17,5.69655E-05,0,2.66655E-06,17
ผช.,11,3.7977E-05,0,2.66655E-06,11
ผญ,10,3.48122E-05,0,2.66655E-06,10
ผบ,0,3.16475E-06,13,3.73316E-05,13
ผบ.,0,3.16475E-06,393,0.001050619,393
ผบ.ทบ.,0,3.16475E-06,256,0.000685302,256
ผบ.ทอ.,0,3.16475E-06,23,6.39971E-05,23
ผม,397,0.001259569,512,0.001367938,909
ผลกระทบ,0,3.16475E-06,87,0.000234656,87
ผลงาน,22,7.27892E-05,33,9.06626E-05,55
ผลประโยชน์,0,3.16475E-06,36,9.86622E-05,36
ผลไม้,10,3.48122E-05,0,2.66655E-06,10
ผลัด,11,3.7977E-05,42,0.000114661,53
ผลิต,100,0.000319639,58,0.000157326,158
ผสม,13,4.43065E-05,29,7.99964E-05,42
ผอ.,0,3.16475E-06,68,0.000183992,68
ผอง,0,3.16475E-06,12,3.46651E-05,12
ผ่อน,0,3.16475E-06,10,2.9332E-05,10
ผ่อนคลาย,89,0.000284827,0,2.66655E-06,89
ผอม,26,8.54482E-05,0,2.66655E-06,26
ผัก,18,6.01302E-05,0,2.66655E-06,18
ผัด,16,5.38007E-05,0,2.66655E-06,16
ผัว,83,0.000265839,0,2.66655E-06,83
ผา,0,3.16475E-06,61,0.000165326,61
ผ่า,11,3.7977E-05,13,3.73316E-05,24
ผ้า,39,0.00012659,44,0.000119995,83
ผ้าห่ม,0,3.16475E-06,10,2.9332E-05,10
ผ้าอนามัย,0,3.16475E-06,13,3.73316E-05,13
ผิ,15,5.0636E-05,0,2.66655E-06,15
ผิดหวัง,25,8.22834E-05,0,2.66655E-06,25
ผิว,75,0.000240521,0,2.66655E-06,75
ผิวขาว,12,4.11417E-05,0,2.66655E-06,12
ผี,24,7.91187E-05,0,2.66655E-06,24
ผืน,0,3.16475E-06,12,3.46651E-05,12
ผู้กอง,0,3.16475E-06,24,6.66636E-05,24
ผู้ก่อเหตุ,0,3.16475E-06,36,9.86622E-05,36
ผู้กำกับ,0,3.16475E-06,10,2.9332E-05,10
ผู้คน,0,3.16475E-06,10,2.9332E-05,10
ผู้ช่วย,0,3.16475E-06,38,0.000103995,38
ผู้ชาย,75,0.000240521,0,2.66655E-06,75
ผู้โดยสาร,0,3.16475E-06,41,0.000111995,41
ผู้ต้องหา,0,3.16475E-06,34,9.33291E-05,34
ผู้ใต้บังคับบัญชา,0,3.16475E-06,11,3.19985E-05,11
ผู้แทน,0,3.16475E-06,30,8.26629E-05,30
ผู้นำ,0,3.16475E-06,56,0.000151993,56
ผู้นำประเทศ,0,3.16475E-06,11,3.19985E-05,11
ผู้บริหาร,13,4.43065E-05,14,3.99982E-05,27
ผู้บังคับการ,0,3.16475E-06,26,7.19967E-05,26
ผู้บังคับบัญชา,0,3.16475E-06,25,6.93302E-05,25
ผู้บัญชาการ,0,3.16475E-06,38,0.000103995,38
ผู้บัญชาการทหารบก,0,3.16475E-06,117,0.000314652,117
ผู้บาดเจ็บ,0,3.16475E-06,63,0.000170659,63
ผู้ปกครอง,0,3.16475E-06,19,5.33309E-05,19
ผู้ประสบภัย,0,3.16475E-06,65,0.000175992,65
ผู้ป่วย,0,3.16475E-06,133,0.000357317,133
ผู้พัน,0,3.16475E-06,21,5.8664E-05,21
ผู้ยากไร้,0,3.16475E-06,14,3.99982E-05,14
ผู้สมัคร,0,3.16475E-06,10,2.9332E-05,10
ผู้สูงอายุ,0,3.16475E-06,11,3.19985E-05,11
ผู้เสียชีวิต,0,3.16475E-06,250,0.000669303,250
ผู้เสียสละ,0,3.16475E-06,20,5.59975E-05,20
ผู้เสียหาย,0,3.16475E-06,19,5.33309E-05,19
ผู้หญิง,47,0.000151908,12,3.46651E-05,59
ผู้ใหญ่,19,6.32949E-05,10,2.9332E-05,29
ผู้อื่น,0,3.16475E-06,24,6.66636E-05,24
เผชิญ,0,3.16475E-06,58,0.000157326,58
เผ็ด,14,4.74712E-05,0,2.66655E-06,14
เผด็จการ,0,3.16475E-06,30,8.26629E-05,30
เผย,0,3.16475E-06,210,0.000562641,210
เผยแพร่,0,3.16475E-06,31,8.53295E-05,31
เผลอ,10,3.48122E-05,0,2.66655E-06,10
เผา,12,4.11417E-05,51,0.00013866,63
แผน,16,5.38007E-05,45,0.000122661,61
แผ่น,11,3.7977E-05,0,2.66655E-06,11
แผนงาน,0,3.16475E-06,14,3.99982E-05,14
แผ่นดิน,28,9.17777E-05,60,0.000162659,88
แผล,0,3.16475E-06,11,3.19985E-05,11
แผ่ว,12,4.11417E-05,0,2.66655E-06,12
ไผ่,0,3.16475E-06,15,4.26647E-05,15
ฝน,20,6.64597E-05,13,3.73316E-05,33
ฝรั่ง,16,5.38007E-05,0,2.66655E-06,16
ฝรั่งเศส,0,3.16475E-06,17,4.79978E-05,17
ฝัง,16,5.38007E-05,0,2.66655E-06,16
ฝั่ง,30,9.81072E-05,32,8.7996E-05,62
ฝั่งธน,14,4.74712E-05,0,2.66655E-06,14
ฝัน,35,0.000113931,26,7.19967E-05,61
ฝันดี,19,6.32949E-05,0,2.66655E-06,19
ฝา,38,0.000123425,0,2.66655E-06,38
ฝาก,112,0.000357616,53,0.000143993,165
ฝาย,0,3.16475E-06,22,6.13306E-05,22
ฝ่ายค้าน,0,3.16475E-06,102,0.000274654,102
ฝิ่น,0,3.16475E-06,21,5.8664E-05,21
ฝีมือ,16,5.38007E-05,0,2.66655E-06,16
ฝึก,26,8.54482E-05,613,0.001637259,639
ฝึกฝน,0,3.16475E-06,21,5.8664E-05,21
ฝุ่น,10,3.48122E-05,171,0.000458646,181
ฝุ่นละออง,0,3.16475E-06,106,0.00028532,106
เฝ้า,10,3.48122E-05,99,0.000266655,109
แฝก,0,3.16475E-06,19,5.33309E-05,19
พ,54,0.000174061,21,5.8664E-05,75
พ.ท.,0,3.16475E-06,41,0.000111995,41
พ.ร.บ.,0,3.16475E-06,23,6.39971E-05,23
พ.ศ.,0,3.16475E-06,21,5.8664E-05,21
พ.อ.,0,3.16475E-06,70,0.000189325,70
พ…,0,3.16475E-06,15,4.26647E-05,15
"พ…""",0,3.16475E-06,15,4.26647E-05,15
พก,25,8.22834E-05,0,2.66655E-06,25
พง,0,3.16475E-06,12,3.46651E-05,12
พงศ์,0,3.16475E-06,16,4.53313E-05,16
พงศกร,0,3.16475E-06,30,8.26629E-05,30
พงษ์,0,3.16475E-06,98,0.000263988,98
พน,27,8.86129E-05,0,2.66655E-06,27
พ่น,0,3.16475E-06,10,2.9332E-05,10
พ้น,12,4.11417E-05,36,9.86622E-05,48
พนักงาน,29,9.49424E-05,0,2.66655E-06,29
พนัส,21,6.96244E-05,0,2.66655E-06,21
พบกัน,0,3.16475E-06,10,2.9332E-05,10
พบปะ,0,3.16475E-06,33,9.06626E-05,33
พปช,0,3.16475E-06,17,4.79978E-05,17
พยาบาล,0,3.16475E-06,12,3.46651E-05,12
พยุหยาตรา,0,3.16475E-06,169,0.000453313,169
พร,23,7.59539E-05,96,0.000258655,119
พรบ.,0,3.16475E-06,17,4.79978E-05,17
พรมแดน,0,3.16475E-06,49,0.000133327,49
พรรค,0,3.16475E-06,657,0.001754587,657
พรรคการเมือง,0,3.16475E-06,60,0.000162659,60
พรรคพวก,0,3.16475E-06,16,4.53313E-05,16
พรรคเพื่อไทย,0,3.16475E-06,18,5.06644E-05,18
พรรคอนาคตใหม่,0,3.16475E-06,268,0.000717301,268
พระ,191,0.000607631,843,0.002250565,1034
พระจันทร์,12,4.11417E-05,0,2.66655E-06,12
พระเจ้า,17,5.69655E-05,35,9.59956E-05,52
พระเจ้าอยู่หัว,0,3.16475E-06,83,0.00022399,83
พระไตรปิฏก,12,4.11417E-05,0,2.66655E-06,12
พระธาตุ,15,5.0636E-05,0,2.66655E-06,15
พระบรมมหาราชวัง,0,3.16475E-06,10,2.9332E-05,10
พระบาทสมเด็จพระพุทธเลิศหล้านภาลัย,0,3.16475E-06,10,2.9332E-05,10
พระประแดง,12,4.11417E-05,0,2.66655E-06,12
พระพุทธเจ้า,0,3.16475E-06,13,3.73316E-05,13
พระมหากรุณาธิคุณ,48,0.000155073,26,7.19967E-05,74
พระมหากษัตริย์,10,3.48122E-05,17,4.79978E-05,27
พระราชกรณียกิจ,0,3.16475E-06,22,6.13306E-05,22
พระราชทาน,0,3.16475E-06,163,0.000437314,163
พระราชพิธี,0,3.16475E-06,144,0.000386649,144
พระราชหฤทัย,0,3.16475E-06,37,0.000101329,37
พระราชา,42,0.000136084,18,5.06644E-05,60
พระราชินี,0,3.16475E-06,30,8.26629E-05,30
พระราม,46,0.000148743,0,2.66655E-06,46
พระศรีรัตนศาสดาราม,0,3.16475E-06,11,3.19985E-05,11
พระองค์,26,8.54482E-05,139,0.000373316,165
พระอาทิตย์,14,4.74712E-05,0,2.66655E-06,14
พระเอก,12,4.11417E-05,0,2.66655E-06,12
พราง,0,3.16475E-06,31,8.53295E-05,31
พริก,17,5.69655E-05,0,2.66655E-06,17
พรีเมี่ยม,14,4.74712E-05,0,2.66655E-06,14
พรุ่งนี้,124,0.000395593,45,0.000122661,169
พฤติกรรม,0,3.16475E-06,21,5.8664E-05,21
พฤศจิกา,36,0.000117096,0,2.66655E-06,36
พล,17,5.69655E-05,1026,0.002738543,1043
พล.ต.,0,3.16475E-06,53,0.000143993,53
พล.ต.อ.,0,3.16475E-06,20,5.59975E-05,20
พล.ท.,0,3.16475E-06,22,6.13306E-05,22
พลตรี,0,3.16475E-06,52,0.000141327,52
พลทหาร,0,3.16475E-06,115,0.000309319,115
พลโท,0,3.16475E-06,78,0.000210657,78
พลเมือง,0,3.16475E-06,36,9.86622E-05,36
พลเรือน,0,3.16475E-06,15,4.26647E-05,15
พลอย,24,7.91187E-05,0,2.66655E-06,24
พลอากาศเอก,0,3.16475E-06,19,5.33309E-05,19
พลเอก,0,3.16475E-06,114,0.000306653,114
พลัง,34,0.000110766,75,0.000202657,109
พลาด,59,0.000189885,11,3.19985E-05,70
พล่าน,0,3.16475E-06,11,3.19985E-05,11
พลี,55,0.000177226,38,0.000103995,93
พวกเรา,40,0.000129755,48,0.000130661,88
พ่อ,724,0.002294442,130,0.000349317,854
พ่อค้า,19,6.32949E-05,0,2.66655E-06,19
พอง,0,3.16475E-06,19,5.33309E-05,19
พอใจ,11,3.7977E-05,0,2.66655E-06,11
พอได้,16,5.38007E-05,0,2.66655E-06,16
พ่อแม่,25,8.22834E-05,0,2.66655E-06,25
พะ,13,4.43065E-05,0,2.66655E-06,13
พะเยา,0,3.16475E-06,19,5.33309E-05,19
พั…,0,3.16475E-06,10,2.9332E-05,10
พัก,111,0.000354452,31,8.53295E-05,142
พักผ่อน,48,0.000155073,0,2.66655E-06,48
พัง,20,6.64597E-05,21,5.8664E-05,41
พัชร,0,3.16475E-06,52,0.000141327,52
พัฒน,28,9.17777E-05,0,2.66655E-06,28
พัฒนา,55,0.000177226,329,0.00087996,384
พัฒนาการ,14,4.74712E-05,0,2.66655E-06,14
พัด,11,3.7977E-05,0,2.66655E-06,11
พัทธ์,34,0.000110766,0,2.66655E-06,34
พัทยา,80,0.000256345,0,2.66655E-06,80
พัน,36,0.000117096,241,0.000645304,277
พันธ์,0,3.16475E-06,63,0.000170659,63
พันธุ์,0,3.16475E-06,10,2.9332E-05,10
พันเอก,0,3.16475E-06,50,0.000135994,50
พาณิชย์,0,3.16475E-06,42,0.000114661,42
พาน,10,3.48122E-05,0,2.66655E-06,10
พาย,24,7.91187E-05,0,2.66655E-06,24
พารากอน,0,3.16475E-06,11,3.19985E-05,11
พิ,35,0.000113931,0,2.66655E-06,35
พิกัด,151,0.000481042,0,2.66655E-06,151
พิค,10,3.48122E-05,0,2.66655E-06,10
พิจารณา,0,3.16475E-06,48,0.000130661,48
พิชัย,0,3.16475E-06,16,4.53313E-05,16
พิทักษ์,0,3.16475E-06,68,0.000183992,68
พิธี,17,5.69655E-05,162,0.000434647,179
พินอคคิ,0,3.16475E-06,11,3.19985E-05,11
พิม,25,8.22834E-05,0,2.66655E-06,25
พิมพ์,18,6.01302E-05,0,2.66655E-06,18
พิศุทธ์,0,3.16475E-06,40,0.000109328,40
พิเศษ,77,0.00024685,148,0.000397315,225
พิษ,0,3.16475E-06,27,7.46633E-05,27
พิษณุโลก,26,8.54482E-05,0,2.66655E-06,26
พิสุทธิ์,0,3.16475E-06,10,2.9332E-05,10
พิสูจน์,0,3.16475E-06,18,5.06644E-05,18
พี,58,0.00018672,0,2.66655E-06,58
พี่,1253,0.003968593,216,0.00057864,1469
พีค,15,5.0636E-05,0,2.66655E-06,15
พี่ชาย,10,3.48122E-05,0,2.66655E-06,10
พี่น้อง,32,0.000104437,154,0.000413315,186
พีร,13,4.43065E-05,10,2.9332E-05,23
พืชผล,0,3.16475E-06,13,3.73316E-05,13
พื้น,21,6.96244E-05,49,0.000133327,70
พื้นที่,66,0.000212038,637,0.001701256,703
พุง,27,8.86129E-05,0,2.66655E-06,27
พุ่ง,19,6.32949E-05,31,8.53295E-05,50
พุด,12,4.11417E-05,0,2.66655E-06,12
พุทธ,25,8.22834E-05,13,3.73316E-05,38
พุทธภูมิ,12,4.11417E-05,0,2.66655E-06,12
พุทธศักราช,0,3.16475E-06,73,0.000197324,73
พุทธิ,0,3.16475E-06,36,9.86622E-05,36
พูดคุย,10,3.48122E-05,12,3.46651E-05,22
พูดถึง,16,5.38007E-05,27,7.46633E-05,43
พูดว่า,13,4.43065E-05,11,3.19985E-05,24
พูน,32,0.000104437,0,2.66655E-06,32
เพ,32,0.000104437,31,8.53295E-05,63
เพ่,13,4.43065E-05,0,2.66655E-06,13
เพคะ,0,3.16475E-06,10,2.9332E-05,10
เพจ,21,6.96244E-05,71,0.000191991,92
เพชร,25,8.22834E-05,31,8.53295E-05,56
เพชรเกษม,14,4.74712E-05,0,2.66655E-06,14
เพชรบุรี,54,0.000174061,0,2.66655E-06,54
เพชรบูรณ์,15,5.0636E-05,0,2.66655E-06,15
เพลง,234,0.000743716,24,6.66636E-05,258
เพลิง,0,3.16475E-06,33,9.06626E-05,33
เพลิงศพ,0,3.16475E-06,42,0.000114661,42
เพลิน,11,3.7977E-05,0,2.66655E-06,11
เพลีย,10,3.48122E-05,0,2.66655E-06,10
เพศ,0,3.16475E-06,14,3.99982E-05,14
เพิ่มขึ้น,0,3.16475E-06,28,7.73298E-05,28
เพิ่มประสิทธิภาพ,0,3.16475E-06,15,4.26647E-05,15
เพิ่อน,0,3.16475E-06,17,4.79978E-05,17
เพียบ,19,6.32949E-05,13,3.73316E-05,32
เพื่อน,311,0.000987401,63,0.000170659,374
แพ,36,0.000117096,0,2.66655E-06,36
แพ้,45,0.000145578,42,0.000114661,87
แพง,34,0.000110766,0,2.66655E-06,34
แพทย์,0,3.16475E-06,170,0.000455979,170
แพร่,18,6.01302E-05,28,7.73298E-05,46
แพร่กระจาย,0,3.16475E-06,12,3.46651E-05,12
แพร่ระบาด,0,3.16475E-06,28,7.73298E-05,28
แพลน,13,4.43065E-05,0,2.66655E-06,13
แพะ,0,3.16475E-06,14,3.99982E-05,14
โพ,30,9.81072E-05,10,2.9332E-05,40
โพล,12,4.11417E-05,0,2.66655E-06,12
โพส,15,5.0636E-05,20,5.59975E-05,35
โพสต์,101,0.000322804,107,0.000287987,208
ฟ,61,0.000196214,14,3.99982E-05,75
ฟรี,276,0.000876635,61,0.000165326,337
ฟอ,23,7.59539E-05,0,2.66655E-06,23
ฟ้อง,14,4.74712E-05,39,0.000106662,53
ฟัง,126,0.000401923,138,0.00037065,264
ฟังเพลง,109,0.000348122,0,2.66655E-06,109
ฟัน,27,8.86129E-05,13,3.73316E-05,40
ฟ้า,107,0.000341793,57,0.00015466,164
ฟาด,13,4.43065E-05,13,3.73316E-05,26
ฟาม,12,4.11417E-05,0,2.66655E-06,12
ฟาร์ม,15,5.0636E-05,0,2.66655E-06,15
ฟิค,10,3.48122E-05,0,2.66655E-06,10
ฟิต,20,6.64597E-05,23,6.39971E-05,43
ฟิตเนส,13,4.43065E-05,0,2.66655E-06,13
ฟิน,54,0.000174061,0,2.66655E-06,54
ฟินๆ,15,5.0636E-05,0,2.66655E-06,15
ฟิล์ม,13,4.43065E-05,0,2.66655E-06,13
ฟิว,60,0.00019305,0,2.66655E-06,60
ฟิวเเฟน,11,3.7977E-05,0,2.66655E-06,11
ฟิวส์,15,5.0636E-05,0,2.66655E-06,15
ฟี,25,8.22834E-05,0,2.66655E-06,25
ฟีฟ่า,0,3.16475E-06,11,3.19985E-05,11
ฟื้นฟู,0,3.16475E-06,17,4.79978E-05,17
ฟุตบอล,0,3.16475E-06,20,5.59975E-05,20
ฟู,27,8.86129E-05,0,2.66655E-06,27
เฟค,0,3.16475E-06,40,0.000109328,40
เฟซบุ๊ก,0,3.16475E-06,15,4.26647E-05,15
เฟส,32,0.000104437,15,4.26647E-05,47
เฟี้ยว,13,4.43065E-05,0,2.66655E-06,13
แฟชั่น,12,4.11417E-05,0,2.66655E-06,12
แฟน,334,0.00106019,22,6.13306E-05,356
แฟนคลับ,41,0.000132919,0,2.66655E-06,41
แฟลช,0,3.16475E-06,14,3.99982E-05,14
โฟกัส,16,5.38007E-05,0,2.66655E-06,16
โฟน,18,6.01302E-05,0,2.66655E-06,18
ไฟ,58,0.00018672,102,0.000274654,160
ไฟเขียว,0,3.16475E-06,12,3.46651E-05,12
ไฟป่า,0,3.16475E-06,368,0.000983955,368
ไฟไหม้,0,3.16475E-06,69,0.000186658,69
ภ,0,3.16475E-06,15,4.26647E-05,15
ภพ,11,3.7977E-05,0,2.66655E-06,11
ภัทร,13,4.43065E-05,12,3.46651E-05,25
ภัย,0,3.16475E-06,92,0.000247989,92
ภัยพิบัติ,0,3.16475E-06,15,4.26647E-05,15
ภัยแล้ง,0,3.16475E-06,205,0.000549308,205
ภา,13,4.43065E-05,46,0.000125328,59
ภาคใต้,31,0.000101272,26,7.19967E-05,57
ภาคพื้นดิน,0,3.16475E-06,15,4.26647E-05,15
ภาครัฐ,0,3.16475E-06,23,6.39971E-05,23
ภาคสนาม,0,3.16475E-06,29,7.99964E-05,29
ภาคเหนือ,13,4.43065E-05,19,5.33309E-05,32
ภาคเอกชน,0,3.16475E-06,16,4.53313E-05,16
ภาพ,100,0.000319639,150,0.000402648,250
ภาพถ่าย,0,3.16475E-06,12,3.46651E-05,12
ภารกิจ,0,3.16475E-06,92,0.000247989,92
ภาระ,0,3.16475E-06,12,3.46651E-05,12
ภาวนา,0,3.16475E-06,11,3.19985E-05,11
ภาษา,19,6.32949E-05,10,2.9332E-05,29
ภาษาจีน,11,3.7977E-05,0,2.66655E-06,11
ภาษาอังกฤษ,12,4.11417E-05,27,7.46633E-05,39
ภาษี,11,3.7977E-05,48,0.000130661,59
ภิญโญ,0,3.16475E-06,13,3.73316E-05,13
ภู,49,0.000158237,100,0.000269321,149
ภูเก็ต,60,0.00019305,41,0.000111995,101
ภูมิ,0,3.16475E-06,11,3.19985E-05,11
ภูมิใจ,37,0.00012026,52,0.000141327,89
ภูมิทัศน์,0,3.16475E-06,27,7.46633E-05,27
ภูมิพล,22,7.27892E-05,0,2.66655E-06,22
ภูมิภาค,0,3.16475E-06,10,2.9332E-05,10
ม,255,0.000810175,59,0.000159993,314
ม่,10,3.48122E-05,0,2.66655E-06,10
ม.,52,0.000167732,234,0.000626638,286
ม…,0,3.16475E-06,12,3.46651E-05,12
มก,0,3.16475E-06,28,7.73298E-05,28
มค.,0,3.16475E-06,11,3.19985E-05,11
ม้ง,0,3.16475E-06,27,7.46633E-05,27
มงคล,15,5.0636E-05,16,4.53313E-05,31
มช,12,4.11417E-05,0,2.66655E-06,12
มณฑล,0,3.16475E-06,215,0.000575974,215
มด,17,5.69655E-05,0,2.66655E-06,17
มติ,0,3.16475E-06,50,0.000135994,50
มติชน,0,3.16475E-06,89,0.000239989,89
มท,0,3.16475E-06,338,0.000903959,338
มนุษย์,0,3.16475E-06,22,6.13306E-05,22
มนุษยธรรม,0,3.16475E-06,20,5.59975E-05,20
มโน,11,3.7977E-05,0,2.66655E-06,11
มม,26,8.54482E-05,0,2.66655E-06,26
มมม,19,6.32949E-05,0,2.66655E-06,19
มมมม,10,3.48122E-05,0,2.66655E-06,10
มมาก,20,6.64597E-05,11,3.19985E-05,31
มรึง,0,3.16475E-06,15,4.26647E-05,15
ม่วง,14,4.74712E-05,0,2.66655E-06,14
มวลชน,0,3.16475E-06,17,4.79978E-05,17
มห…,0,3.16475E-06,13,3.73316E-05,13
มหา,35,0.000113931,63,0.000170659,98
มหาชัย,38,0.000123425,27,7.46633E-05,65
มหาดเล็ก,0,3.16475E-06,16,4.53313E-05,16
มหาราช,32,0.000104437,39,0.000106662,71
มหาลัย,38,0.000123425,0,2.66655E-06,38
มหาวิทยาลัย,14,4.74712E-05,0,2.66655E-06,14
มอ,57,0.000183555,18,5.06644E-05,75
มองผ่าน,0,3.16475E-06,114,0.000306653,114
มอญ,23,7.59539E-05,0,2.66655E-06,23
มอเตอร์,0,3.16475E-06,40,0.000109328,40
มอน,0,3.16475E-06,14,3.99982E-05,14
ม่อน,19,6.32949E-05,11,3.19985E-05,30
มอบ,13,4.43065E-05,158,0.000423981,171
ม๊อบ,0,3.16475E-06,27,7.46633E-05,27
ม็อบ,93,0.000297486,70,0.000189325,163
มอบหมาย,0,3.16475E-06,30,8.26629E-05,30
มอลล์,16,5.38007E-05,0,2.66655E-06,16
มะ,73,0.000234191,16,4.53313E-05,89
ม่ะ,24,7.91187E-05,0,2.66655E-06,24
มะกัน,0,3.16475E-06,13,3.73316E-05,13
มะโรง,0,3.16475E-06,20,5.59975E-05,20
มั่ง,15,5.0636E-05,0,2.66655E-06,15
มั้ง,52,0.000167732,32,8.7996E-05,84
มังกร,19,6.32949E-05,0,2.66655E-06,19
มัดจำ,23,7.59539E-05,0,2.66655E-06,23
มัธยม,52,0.000167732,0,2.66655E-06,52
มั่น,10,3.48122E-05,0,2.66655E-06,10
มั่นใจ,18,6.01302E-05,35,9.59956E-05,53
มันดี,26,8.54482E-05,0,2.66655E-06,26
มันส์,39,0.00012659,0,2.66655E-06,39
มั่ว,0,3.16475E-06,45,0.000122661,45
มัวแต่,0,3.16475E-06,24,6.66636E-05,24
ม้า,48,0.000155073,0,2.66655E-06,48
ม๊า,19,6.32949E-05,0,2.66655E-06,19
มากขึ้น,21,6.96244E-05,21,5.8664E-05,42
มาจาก,52,0.000167732,73,0.000197324,125
มาด,10,3.48122E-05,0,2.66655E-06,10
มาดาม,0,3.16475E-06,11,3.19985E-05,11
มาโดยตลอด,0,3.16475E-06,25,6.93302E-05,25
มาตร,0,3.16475E-06,14,3.99982E-05,14
มาตรการ,0,3.16475E-06,92,0.000247989,92
มาตรฐาน,11,3.7977E-05,38,0.000103995,49
มาตรา,0,3.16475E-06,46,0.000125328,46
มาถึง,37,0.00012026,24,6.66636E-05,61
มานะ,46,0.000148743,0,2.66655E-06,46
มาบ,18,6.01302E-05,0,2.66655E-06,18
มาม่า,17,5.69655E-05,0,2.66655E-06,17
มาย,20,6.64597E-05,0,2.66655E-06,20
ม่าย,19,6.32949E-05,0,2.66655E-06,19
มาร,0,3.16475E-06,13,3.73316E-05,13
มาร์ค,17,5.69655E-05,0,2.66655E-06,17
มาร์ช,13,4.43065E-05,0,2.66655E-06,13
มารยาท,10,3.48122E-05,0,2.66655E-06,10
มาราธอน,0,3.16475E-06,13,3.73316E-05,13
มาเลเซีย,0,3.16475E-06,19,5.33309E-05,19
มาหา,111,0.000354452,13,3.73316E-05,124
มิด,14,4.74712E-05,0,2.66655E-06,14
มิตร,12,4.11417E-05,13,3.73316E-05,25
มิตรภาพ,10,3.48122E-05,50,0.000135994,60
มิติ,0,3.16475E-06,13,3.73316E-05,13
มินิ,0,3.16475E-06,14,3.99982E-05,14
มี่,36,0.000117096,0,2.66655E-06,36
มี้,10,3.48122E-05,0,2.66655E-06,10
มี๊,24,7.91187E-05,0,2.66655E-06,24
มีเกียรติ,0,3.16475E-06,16,4.53313E-05,16
มีคดี,0,3.16475E-06,10,2.9332E-05,10
มีความสุข,96,0.00030698,17,4.79978E-05,113
มีค่า,20,6.64597E-05,71,0.000191991,91
มีเงิน,27,8.86129E-05,22,6.13306E-05,49
มีใจ,10,3.48122E-05,0,2.66655E-06,10
มีชีวิต,13,4.43065E-05,10,2.9332E-05,23
มีเดีย,0,3.16475E-06,13,3.73316E-05,13
มีต,16,5.38007E-05,0,2.66655E-06,16
มีน,17,5.69655E-05,0,2.66655E-06,17
มีประโยชน์,0,3.16475E-06,23,6.39971E-05,23
มีประสิทธิภาพ,0,3.16475E-06,11,3.19985E-05,11
มีปัญหา,14,4.74712E-05,23,6.39971E-05,37
มีผล,0,3.16475E-06,13,3.73316E-05,13
มีมติ,0,3.16475E-06,15,4.26647E-05,15
มีเรื่อง,20,6.64597E-05,15,4.26647E-05,35
มีวินัย,0,3.16475E-06,17,4.79978E-05,17
มีสติ,0,3.16475E-06,41,0.000111995,41
มีส่วน,0,3.16475E-06,17,4.79978E-05,17
มีสิทธิ์,0,3.16475E-06,12,3.46651E-05,12
มีเหตุผล,0,3.16475E-06,13,3.73316E-05,13
มีอำนาจ,0,3.16475E-06,21,5.8664E-05,21
มีโอกาส,24,7.91187E-05,25,6.93302E-05,49
มืด,16,5.38007E-05,0,2.66655E-06,16
มือ,101,0.000322804,64,0.000173325,165
มื้อ,28,9.17777E-05,0,2.66655E-06,28
มือถือ,31,0.000101272,13,3.73316E-05,44
มือปืน,0,3.16475E-06,14,3.99982E-05,14
มือสอง,20,6.64597E-05,0,2.66655E-06,20
มือหนัก,0,3.16475E-06,18,5.06644E-05,18
มุ,25,8.22834E-05,0,2.66655E-06,25
มุก,63,0.000202544,0,2.66655E-06,63
มุกดา,21,6.96244E-05,20,5.59975E-05,41
มุข,13,4.43065E-05,0,2.66655E-06,13
มุ่งมั่น,0,3.16475E-06,21,5.8664E-05,21
มุ่งหน้า,0,3.16475E-06,25,6.93302E-05,25
มุม,64,0.000205709,27,7.46633E-05,91
มูฟ,15,5.0636E-05,0,2.66655E-06,15
มูลนิธิ,0,3.16475E-06,16,4.53313E-05,16
เม,71,0.000227862,31,8.53295E-05,102
เม็ด,21,6.96244E-05,39,0.000106662,60
เมท,14,4.74712E-05,0,2.66655E-06,14
เมธา,0,3.16475E-06,66,0.000178659,66
เมน,73,0.000234191,0,2.66655E-06,73
เม้น,46,0.000148743,0,2.66655E-06,46
เมนู,46,0.000148743,12,3.46651E-05,58
เมล,16,5.38007E-05,0,2.66655E-06,16
เมา,66,0.000212038,0,2.66655E-06,66
เม้า,16,5.38007E-05,0,2.66655E-06,16
เมิง,18,6.01302E-05,0,2.66655E-06,18
เมีย,55,0.000177226,30,8.26629E-05,85
เมือง,203,0.000645608,238,0.000637304,441
เมื่อย,14,4.74712E-05,0,2.66655E-06,14
แม่,612,0.00193999,157,0.000421314,769
แม่ค้า,19,6.32949E-05,0,2.66655E-06,19
แม่ทัพ,0,3.16475E-06,201,0.000538642,201
แมน,21,6.96244E-05,0,2.66655E-06,21
แม่น้ำ,13,4.43065E-05,25,6.93302E-05,38
แม่บ้าน,19,6.32949E-05,62,0.000167992,81
แมว,65,0.000208873,10,2.9332E-05,75
แมส,38,0.000123425,0,2.66655E-06,38
แม่ฮ่องสอน,13,4.43065E-05,15,4.26647E-05,28
แมะ,17,5.69655E-05,0,2.66655E-06,17
โม,42,0.000136084,36,9.86622E-05,78
โมง,76,0.000243686,18,5.06644E-05,94
โมโห,13,4.43065E-05,0,2.66655E-06,13
ไม,20,6.64597E-05,13,3.73316E-05,33
ไม้,18,6.01302E-05,25,6.93302E-05,43
ไมค์,30,9.81072E-05,0,2.66655E-06,30
ไม่งั้น,16,5.38007E-05,11,3.19985E-05,27
ไม่ต้อง,215,0.000683585,101,0.000271988,316
ย์,58,0.00018672,23,6.39971E-05,81
ย,265,0.000841823,55,0.000149327,320
ย&,13,4.43065E-05,0,2.66655E-06,13
ยกตัวอย่าง,0,3.16475E-06,14,3.99982E-05,14
ยกย่อง,0,3.16475E-06,18,5.06644E-05,18
ยกเลิก,10,3.48122E-05,52,0.000141327,62
ยกเว้น,13,4.43065E-05,0,2.66655E-06,13
ยย,187,0.000594972,22,6.13306E-05,209
ยยย,144,0.000458888,0,2.66655E-06,144
ยยยย,73,0.000234191,0,2.66655E-06,73
ยยยยย,37,0.00012026,0,2.66655E-06,37
ยยยยยย,16,5.38007E-05,0,2.66655E-06,16
ยยยยยยย,10,3.48122E-05,0,2.66655E-06,10
ยยยยยยยย,11,3.7977E-05,0,2.66655E-06,11
ยศ,0,3.16475E-06,21,5.8664E-05,21
ยอ,11,3.7977E-05,0,2.66655E-06,11
ยอง,63,0.000202544,0,2.66655E-06,63
ยอด,84,0.000269004,98,0.000263988,182
ยอดเยี่ยม,0,3.16475E-06,20,5.59975E-05,20
ยอน,37,0.00012026,0,2.66655E-06,37
ย้อน,23,7.59539E-05,28,7.73298E-05,51
ย้อนหลัง,19,6.32949E-05,15,4.26647E-05,34
ย้อม,10,3.48122E-05,0,2.66655E-06,10
ยะ,0,3.16475E-06,20,5.59975E-05,20
ยะลา,12,4.11417E-05,76,0.000205324,88
ยังมี,43,0.000139249,51,0.00013866,94
ยังอยู่,21,6.96244E-05,20,5.59975E-05,41
ยัน,30,9.81072E-05,139,0.000373316,169
ยัย,39,0.00012659,0,2.66655E-06,39
ยา,79,0.00025318,113,0.000303986,192
ย่า,13,4.43065E-05,37,0.000101329,50
ยาง,16,5.38007E-05,30,8.26629E-05,46
ย่าง,33,0.000107601,10,2.9332E-05,43
ย่าน,19,6.32949E-05,0,2.66655E-06,19
ยานพาหนะ,0,3.16475E-06,27,7.46633E-05,27
ยาบ้า,0,3.16475E-06,69,0.000186658,69
ยาม,27,8.86129E-05,52,0.000141327,79
ยาย,32,0.000104437,14,3.99982E-05,46
ย้าย,21,6.96244E-05,43,0.000117328,64
ย้ายออก,0,3.16475E-06,11,3.19985E-05,11
ยาเสพติด,0,3.16475E-06,81,0.000218657,81
ยำ,36,0.000117096,0,2.66655E-06,36
ย้ำ,14,4.74712E-05,41,0.000111995,55
ยิง,16,5.38007E-05,570,0.001522598,586
ยิงปืน,0,3.16475E-06,68,0.000183992,68
ยินดี,43,0.000139249,31,8.53295E-05,74
ยินดีต้อนรับ,21,6.96244E-05,0,2.66655E-06,21
ยิ้ม,96,0.00030698,30,8.26629E-05,126
ยีราฟ,0,3.16475E-06,12,3.46651E-05,12
ยึด,0,3.16475E-06,113,0.000303986,113
ยึดทรัพย์,0,3.16475E-06,13,3.73316E-05,13
ยืด,12,4.11417E-05,0,2.66655E-06,12
ยืน,71,0.000227862,56,0.000151993,127
ยื่น,0,3.16475E-06,33,9.06626E-05,33
ยืม,16,5.38007E-05,0,2.66655E-06,16
ยุ,64,0.000205709,54,0.00014666,118
ยุ่,20,6.64597E-05,0,2.66655E-06,20
ยุค,32,0.000104437,57,0.00015466,89
ยุคใหม่,0,3.16475E-06,18,5.06644E-05,18
ยุง,0,3.16475E-06,12,3.46651E-05,12
ยุ่ง,20,6.64597E-05,16,4.53313E-05,36
ยุด,10,3.48122E-05,0,2.66655E-06,10
ยุติ,0,3.16475E-06,38,0.000103995,38
ยุติธรรม,0,3.16475E-06,19,5.33309E-05,19
ยุทธ,0,3.16475E-06,17,4.79978E-05,17
ยุทโธปกรณ์,0,3.16475E-06,36,9.86622E-05,36
ยุบ,0,3.16475E-06,512,0.001367938,512
ยุโรป,0,3.16475E-06,18,5.06644E-05,18
ยู,80,0.000256345,13,3.73316E-05,93
ยู่,17,5.69655E-05,0,2.66655E-06,17
เย,152,0.000484206,56,0.000151993,208
เย้,37,0.00012026,0,2.66655E-06,37
เย็ด,840,0.002661552,0,2.66655E-06,840
เย็น,142,0.000452559,30,8.26629E-05,172
เย็นสบาย,18,6.01302E-05,0,2.66655E-06,18
เยอรมัน,10,3.48122E-05,0,2.66655E-06,10
เยาวชน,10,3.48122E-05,34,9.33291E-05,44
เยี่ยม,29,9.49424E-05,353,0.000943957,382
เยี่ยมเยียน,0,3.16475E-06,12,3.46651E-05,12
เยียวยา,11,3.7977E-05,69,0.000186658,80
เยือน,0,3.16475E-06,34,9.33291E-05,34
แย่,41,0.000132919,32,8.7996E-05,73
แย้,28,9.17777E-05,0,2.66655E-06,28
แยก,55,0.000177226,26,7.19967E-05,81
แย่ง,16,5.38007E-05,0,2.66655E-06,16
แย้ง,0,3.16475E-06,10,2.9332E-05,10
แย่มาก,0,3.16475E-06,15,4.26647E-05,15
โย,0,3.16475E-06,16,4.53313E-05,16
โยง,0,3.16475E-06,40,0.000109328,40
โยธิน,0,3.16475E-06,31,8.53295E-05,31
โยน,0,3.16475E-06,11,3.19985E-05,11
ร์,22,7.27892E-05,21,5.8664E-05,43
ร,96,0.00030698,39,0.000106662,135
ร่,13,4.43065E-05,0,2.66655E-06,13
ร.,54,0.000174061,245,0.00065597,299
ร.ด.,0,3.16475E-06,12,3.46651E-05,12
ร.ต.อ.,0,3.16475E-06,13,3.73316E-05,13
ร.อ.,0,3.16475E-06,39,0.000106662,39
ร…,0,3.16475E-06,13,3.73316E-05,13
"ร…""",0,3.16475E-06,22,6.13306E-05,22
รณรงค์,0,3.16475E-06,111,0.000298653,111
รณิ,0,3.16475E-06,44,0.000119995,44
รด,11,3.7977E-05,0,2.66655E-06,11
รต,20,6.64597E-05,0,2.66655E-06,20
รถ,149,0.000474712,126,0.000338651,275
รถติด,15,5.0636E-05,0,2.66655E-06,15
รถถัง,0,3.16475E-06,15,4.26647E-05,15
รถบรรทุก,0,3.16475E-06,85,0.000229323,85
รถไฟ,20,6.64597E-05,19,5.33309E-05,39
รถไฟฟ้า,14,4.74712E-05,58,0.000157326,72
รถยนต์,0,3.16475E-06,64,0.000173325,64
ร์ท,0,3.16475E-06,12,3.46651E-05,12
รธน,0,3.16475E-06,11,3.19985E-05,11
รธน.,0,3.16475E-06,64,0.000173325,64
รน,23,7.59539E-05,0,2.66655E-06,23
รบ,0,3.16475E-06,154,0.000413315,154
รบ.,0,3.16475E-06,49,0.000133327,49
รบกวน,12,4.11417E-05,0,2.66655E-06,12
รปภ.,0,3.16475E-06,23,6.39971E-05,23
รปห.,0,3.16475E-06,10,2.9332E-05,10
รพ.,0,3.16475E-06,129,0.000346651,129
รม,18,6.01302E-05,0,2.66655E-06,18
รมช.,0,3.16475E-06,16,4.53313E-05,16
รมต.,0,3.16475E-06,15,4.26647E-05,15
รมน.,0,3.16475E-06,10,2.9332E-05,10
ร่มรื่น,0,3.16475E-06,19,5.33309E-05,19
รมว.,0,3.16475E-06,57,0.00015466,57
รร,50,0.000161402,18,5.06644E-05,68
รร.,17,5.69655E-05,45,0.000122661,62
รวบ,0,3.16475E-06,10,2.9332E-05,10
ร่วมกับ,0,3.16475E-06,170,0.000455979,170
ร่วมงาน,40,0.000129755,54,0.00014666,94
ร่วมใจ,0,3.16475E-06,66,0.000178659,66
ร่วมมือร่วมใจ,0,3.16475E-06,19,5.33309E-05,19
รวย,45,0.000145578,12,3.46651E-05,57
รส,35,0.000113931,0,2.66655E-06,35
รสชาติ,12,4.11417E-05,0,2.66655E-06,12
รหัส,10,3.48122E-05,0,2.66655E-06,10
รอ,421,0.001335523,377,0.001007954,798
รอ.,0,3.16475E-06,179,0.000479978,179
รอง,20,6.64597E-05,243,0.000650637,263
ร้อง,82,0.000262674,50,0.000135994,132
รองเท้า,40,0.000129755,0,2.66655E-06,40
รองพื้น,13,4.43065E-05,0,2.66655E-06,13
ร้องเพลง,48,0.000155073,14,3.99982E-05,62
รองรับ,0,3.16475E-06,15,4.26647E-05,15
ร้องเรียน,0,3.16475E-06,37,0.000101329,37
ร้องไห้,70,0.000224697,11,3.19985E-05,81
รอด,31,0.000101272,109,0.00029332,140
ร้อน,91,0.000291157,33,9.06626E-05,124
รอบ,167,0.000531678,74,0.000199991,241
รอย,22,7.27892E-05,0,2.66655E-06,22
ร้อย,33,0.000107601,76,0.000205324,109
รอยยิ้ม,35,0.000113931,18,5.06644E-05,53
ร้อยเอ็ด,18,6.01302E-05,0,2.66655E-06,18
รอยัล,0,3.16475E-06,11,3.19985E-05,11
ระ,25,8.22834E-05,29,7.99964E-05,54
ระดม,0,3.16475E-06,23,6.39971E-05,23
ระดมกำลัง,0,3.16475E-06,11,3.19985E-05,11
ระดับ,30,9.81072E-05,34,9.33291E-05,64
ระบบ,25,8.22834E-05,97,0.000261321,122
ระบอบประชาธิปไตย,0,3.16475E-06,10,2.9332E-05,10
ระบาด,10,3.48122E-05,65,0.000175992,75
ระบาย,11,3.7977E-05,0,2.66655E-06,11
ระบุ,11,3.7977E-05,71,0.000191991,82
ระเบิด,0,3.16475E-06,13,3.73316E-05,13
ระเบียบ,0,3.16475E-06,13,3.73316E-05,13
ระเบียบวินัย,0,3.16475E-06,13,3.73316E-05,13
ระมัดระวัง,0,3.16475E-06,16,4.53313E-05,16
ระยอง,139,0.000443065,0,2.66655E-06,139
ระยำ,0,3.16475E-06,21,5.8664E-05,21
ระวัง,27,8.86129E-05,158,0.000423981,185
ระหว่างทาง,10,3.48122E-05,0,2.66655E-06,10
รัก,919,0.002911567,237,0.000634638,1156
รักษ์,14,4.74712E-05,52,0.000141327,66
รักษา,16,5.38007E-05,135,0.00036265,151
รักษาการณ์,0,3.16475E-06,13,3.73316E-05,13
รักษาสุขภาพ,0,3.16475E-06,13,3.73316E-05,13
รังแก,0,3.16475E-06,12,3.46651E-05,12
รังสิต,73,0.000234191,0,2.66655E-06,73
รัชกาล,27,8.86129E-05,21,5.8664E-05,48
รัชดา,48,0.000155073,0,2.66655E-06,48
รัชต,0,3.16475E-06,68,0.000183992,68
รัฐ,18,6.01302E-05,156,0.000418648,174
รัฐธรรมนูญ,0,3.16475E-06,35,9.59956E-05,35
รัฐบาล,44,0.000142414,393,0.001050619,437
รัฐประหาร,0,3.16475E-06,40,0.000109328,40
รัฐมนตรี,0,3.16475E-06,31,8.53295E-05,31
รัฐสภา,0,3.16475E-06,11,3.19985E-05,11
รัตติกาล,0,3.16475E-06,26,7.19967E-05,26
รัตน์,0,3.16475E-06,16,4.53313E-05,16
รัตน,0,3.16475E-06,18,5.06644E-05,18
รัตนาธิเบศร์,10,3.48122E-05,0,2.66655E-06,10
รัน,18,6.01302E-05,0,2.66655E-06,18
รับงาน,2285,0.007234612,0,2.66655E-06,2285
รับเงิน,13,4.43065E-05,11,3.19985E-05,24
รับได้,15,5.0636E-05,0,2.66655E-06,15
รับโทษ,0,3.16475E-06,15,4.26647E-05,15
รับบริจาค,16,5.38007E-05,15,4.26647E-05,31
รับประกัน,26,8.54482E-05,0,2.66655E-06,26
รับผิดชอบ,0,3.16475E-06,39,0.000106662,39
รับฟัง,0,3.16475E-06,26,7.19967E-05,26
รับมือ,0,3.16475E-06,47,0.000127994,47
รับรู้,0,3.16475E-06,12,3.46651E-05,12
รับสมัคร,0,3.16475E-06,14,3.99982E-05,14
รับเสด็จ,19,6.32949E-05,0,2.66655E-06,19
รั่ม,21,6.96244E-05,0,2.66655E-06,21
รัย,17,5.69655E-05,0,2.66655E-06,17
รัล,10,3.48122E-05,0,2.66655E-06,10
รัว,17,5.69655E-05,0,2.66655E-06,17
รั้ว,0,3.16475E-06,26,7.19967E-05,26
รา,35,0.000113931,130,0.000349317,165
ร่า,14,4.74712E-05,0,2.66655E-06,14
ร้า,147,0.000468383,56,0.000151993,203
ราคา,226,0.000718398,34,9.33291E-05,260
ราง,0,3.16475E-06,12,3.46651E-05,12
ร่าง,13,4.43065E-05,66,0.000178659,79
ร่างกาย,28,9.17777E-05,70,0.000189325,98
รางวัล,50,0.000161402,41,0.000111995,91
ราช,45,0.000145578,157,0.000421314,202
ราชการ,0,3.16475E-06,38,0.000103995,38
ราชธิดา,0,3.16475E-06,25,6.93302E-05,25
ราชบุรี,34,0.000110766,24,6.66636E-05,58
ราชประเพณี,0,3.16475E-06,24,6.66636E-05,24
ราชินี,0,3.16475E-06,19,5.33309E-05,19
ร่าน,10,3.48122E-05,12,3.46651E-05,22
ร้าน,394,0.001250075,114,0.000306653,508
ร้านกาแฟ,22,7.27892E-05,0,2.66655E-06,22
ร้านเหล้า,13,4.43065E-05,0,2.66655E-06,13
ร้านอาหาร,27,8.86129E-05,0,2.66655E-06,27
ราบ,18,6.01302E-05,0,2.66655E-06,18
ราบรื่น,0,3.16475E-06,12,3.46651E-05,12
ราม,42,0.000136084,13,3.73316E-05,55
รามคำแหง,19,6.32949E-05,0,2.66655E-06,19
รามอินทรา,41,0.000132919,0,2.66655E-06,41
ร้าย,37,0.00012026,35,9.59956E-05,72
รายการ,44,0.000142414,94,0.000253322,138
รายงาน,0,3.16475E-06,101,0.000271988,101
รายงานตัว,20,6.64597E-05,0,2.66655E-06,20
รายชื่อ,0,3.16475E-06,18,5.06644E-05,18
รายได้,14,4.74712E-05,54,0.00014666,68
ร้ายแรง,0,3.16475E-06,37,0.000101329,37
รายละเอียด,45,0.000145578,14,3.99982E-05,59
ราษฎร์,0,3.16475E-06,32,8.7996E-05,32
ราษฎร,21,6.96244E-05,11,3.19985E-05,32
รำ,12,4.11417E-05,0,2.66655E-06,12
รำคาญ,12,4.11417E-05,0,2.66655E-06,12
รำลึก,31,0.000101272,10,2.9332E-05,41
ริ,187,0.000594972,163,0.000437314,350
ริน,41,0.000132919,21,5.8664E-05,62
ริม,24,7.91187E-05,0,2.66655E-06,24
ริมน้ำ,10,3.48122E-05,0,2.66655E-06,10
รี,220,0.000699409,112,0.00030132,332
รี่,65,0.000208873,12,3.46651E-05,77
รี้,29,9.49424E-05,0,2.66655E-06,29
รีด,26,8.54482E-05,0,2.66655E-06,26
รีบ,96,0.00030698,47,0.000127994,143
รีม,17,5.69655E-05,0,2.66655E-06,17
รีวิว,162,0.000515854,0,2.66655E-06,162
รีสอร์ท,13,4.43065E-05,0,2.66655E-06,13
รึเปล่า,25,8.22834E-05,34,9.33291E-05,59
รุ,27,8.86129E-05,0,2.66655E-06,27
รุ้,23,7.59539E-05,0,2.66655E-06,23
รุก,39,0.00012659,18,5.06644E-05,57
รุ่งเรือง,0,3.16475E-06,10,2.9332E-05,10
รุ่น,30,9.81072E-05,95,0.000255988,125
รุนแรง,0,3.16475E-06,37,0.000101329,37
รุ่นใหม่,0,3.16475E-06,10,2.9332E-05,10
รุม,0,3.16475E-06,12,3.46651E-05,12
รู,28,9.17777E-05,0,2.66655E-06,28
รู้,411,0.001303876,368,0.000983955,779
รู้กัน,0,3.16475E-06,26,7.19967E-05,26
รู้จัก,68,0.000218368,45,0.000122661,113
รู้ตัว,23,7.59539E-05,0,2.66655E-06,23
รู้ทัน,0,3.16475E-06,21,5.8664E-05,21
รู้เท่าทัน,0,3.16475E-06,24,6.66636E-05,24
รูป,293,0.000930436,78,0.000210657,371
รูปแบบ,15,5.0636E-05,28,7.73298E-05,43
รูปภาพ,78,0.000250015,0,2.66655E-06,78
รู้เรื่อง,15,5.0636E-05,12,3.46651E-05,27
รู้สึก,136,0.00043357,96,0.000258655,232
เร,29,9.49424E-05,83,0.00022399,112
เร่ง,39,0.00012659,133,0.000357317,172
เร่งด่วน,0,3.16475E-06,18,5.06644E-05,18
เรท,42,0.000136084,0,2.66655E-06,42
เรย,49,0.000158237,11,3.19985E-05,60
เริ่ด,35,0.000113931,0,2.66655E-06,35
เริ่มต้น,24,7.91187E-05,0,2.66655E-06,24
เรียกร้อง,15,5.0636E-05,56,0.000151993,71
เรียน,104,0.000332298,52,0.000141327,156
เรียนรู้,20,6.64597E-05,48,0.000130661,68
เรียบร้อย,38,0.000123425,31,8.53295E-05,69
เรียล,42,0.000136084,0,2.66655E-06,42
เรือ,51,0.000164567,185,0.000495978,236
เรื่อง,321,0.001019049,675,0.001802585,996
เรื่องจริง,14,4.74712E-05,0,2.66655E-06,14
เรื่องราว,13,4.43065E-05,31,8.53295E-05,44
เรื่องเล่า,0,3.16475E-06,29,7.99964E-05,29
เรื่องใหญ่,0,3.16475E-06,13,3.73316E-05,13
เรือนจำ,0,3.16475E-06,10,2.9332E-05,10
เรือพระที่นั่ง,0,3.16475E-06,14,3.99982E-05,14
เรือรูปสัตว์,0,3.16475E-06,15,4.26647E-05,15
แรง,112,0.000357616,28,7.73298E-05,140
แรงงาน,0,3.16475E-06,24,6.66636E-05,24
แรงใจ,0,3.16475E-06,23,6.39971E-05,23
แร้ว,21,6.96244E-05,0,2.66655E-06,21
แระ,16,5.38007E-05,0,2.66655E-06,16
โร,19,6.32949E-05,394,0.001053286,413
โรค,27,8.86129E-05,120,0.000322652,147
โรคติดต่อ,0,3.16475E-06,38,0.000103995,38
โรง,35,0.000113931,27,7.46633E-05,62
โรงงาน,0,3.16475E-06,20,5.59975E-05,20
โรงพยาบาล,28,9.17777E-05,124,0.000333318,152
โรงเรียน,51,0.000164567,158,0.000423981,209
โรงแรม,36,0.000117096,0,2.66655E-06,36
โรงอาหาร,0,3.16475E-06,40,0.000109328,40
โรจ,17,5.69655E-05,0,2.66655E-06,17
โรบินสัน,13,4.43065E-05,0,2.66655E-06,13
โรม่า,20,6.64597E-05,0,2.66655E-06,20
ไร่,19,6.32949E-05,67,0.000181325,86
ไร้,22,7.27892E-05,59,0.000159993,81
ฤดูหนาว,13,4.43065E-05,0,2.66655E-06,13
ล์,15,5.0636E-05,0,2.66655E-06,15
ล,209,0.000664597,32,8.7996E-05,241
ล.,0,3.16475E-06,75,0.000202657,75
ลงข่าว,0,3.16475E-06,13,3.73316E-05,13
ลงชื่อ,0,3.16475E-06,57,0.00015466,57
ลงทะเบียน,19,6.32949E-05,0,2.66655E-06,19
ลงโทษ,0,3.16475E-06,21,5.8664E-05,21
ลงนาม,0,3.16475E-06,33,9.06626E-05,33
ลงมติ,0,3.16475E-06,27,7.46633E-05,27
ลงมา,17,5.69655E-05,0,2.66655E-06,17
ลด,62,0.000199379,139,0.000373316,201
ลดลง,16,5.38007E-05,22,6.13306E-05,38
ล้น,13,4.43065E-05,0,2.66655E-06,13
ลบ,30,9.81072E-05,52,0.000141327,82
ลพบุรี,43,0.000139249,147,0.000394649,190
ลม,38,0.000123425,21,5.8664E-05,59
ล่ม,21,6.96244E-05,0,2.66655E-06,21
ล้ม,14,4.74712E-05,45,0.000122661,59
ล้มล้าง,0,3.16475E-06,22,6.13306E-05,22
ลมหนาว,23,7.59539E-05,0,2.66655E-06,23
ลวก,0,3.16475E-06,51,0.00013866,51
ลวง,97,0.000310145,0,2.66655E-06,97
ล่วงหน้า,15,5.0636E-05,11,3.19985E-05,26
ล้อ,15,5.0636E-05,0,2.66655E-06,15
ลอก,0,3.16475E-06,16,4.53313E-05,16
ล็อก,15,5.0636E-05,0,2.66655E-06,15
ล็อค,16,5.38007E-05,0,2.66655E-06,16
ลอง,162,0.000515854,67,0.000181325,229
ล้อมรอบ,0,3.16475E-06,15,4.26647E-05,15
ลอย,15,5.0636E-05,29,7.99964E-05,44
ล่ะ,196,0.000623455,114,0.000306653,310
ละคร,17,5.69655E-05,0,2.66655E-06,17
ละมุน,19,6.32949E-05,0,2.66655E-06,19
ละเมิด,0,3.16475E-06,16,4.53313E-05,16
ละลาย,15,5.0636E-05,0,2.66655E-06,15
ละออง,0,3.16475E-06,17,4.79978E-05,17
ลักลอบ,0,3.16475E-06,60,0.000162659,60
ลักษณ์,0,3.16475E-06,24,6.66636E-05,24
ลัค,0,3.16475E-06,10,2.9332E-05,10
ลัง,26,8.54482E-05,0,2.66655E-06,26
ลัทธิ,0,3.16475E-06,23,6.39971E-05,23
ลั่น,22,7.27892E-05,40,0.000109328,62
ลั่นไก,0,3.16475E-06,16,4.53313E-05,16
ลับ,25,8.22834E-05,0,2.66655E-06,25
ลัฟ,53,0.000170896,0,2.66655E-06,53
ลัย,12,4.11417E-05,0,2.66655E-06,12
ลา,85,0.000272168,62,0.000167992,147
ล่า,43,0.000139249,16,4.53313E-05,59
ล้า,15,5.0636E-05,0,2.66655E-06,15
ลาก,20,6.64597E-05,0,2.66655E-06,20
ล่าง,34,0.000110766,10,2.9332E-05,44
ล้าง,28,9.17777E-05,53,0.000143993,81
ล้างมือ,0,3.16475E-06,23,6.39971E-05,23
ลาด,17,5.69655E-05,12,3.46651E-05,29
ลาดกระบัง,18,6.01302E-05,0,2.66655E-06,18
ลาดตระเวน,0,3.16475E-06,21,5.8664E-05,21
ลาดพร้าว,57,0.000183555,0,2.66655E-06,57
ลาน,26,8.54482E-05,30,8.26629E-05,56
ล้าน,75,0.000240521,216,0.00057864,291
ลาบ,14,4.74712E-05,0,2.66655E-06,14
ลาม,0,3.16475E-06,11,3.19985E-05,11
ลาย,40,0.000129755,33,9.06626E-05,73
ลาว,0,3.16475E-06,50,0.000135994,50
ลาออก,10,3.48122E-05,65,0.000175992,75
ลำ,35,0.000113931,42,0.000114661,77
ลำดับ,0,3.16475E-06,15,4.26647E-05,15
ลำน้ำ,0,3.16475E-06,10,2.9332E-05,10
ลำบาก,12,4.11417E-05,20,5.59975E-05,32
ลำบากใจ,0,3.16475E-06,28,7.73298E-05,28
ลำปาง,18,6.01302E-05,0,2.66655E-06,18
ลำพูน,28,9.17777E-05,0,2.66655E-06,28
ลำโพง,17,5.69655E-05,0,2.66655E-06,17
ลำไย,13,4.43065E-05,0,2.66655E-06,13
ลิ,49,0.000158237,0,2.66655E-06,49
ลิง,24,7.91187E-05,0,2.66655E-06,24
ลิงค์,0,3.16475E-06,10,2.9332E-05,10
ลิ้งค์,14,4.74712E-05,15,4.26647E-05,29
ลิตร,0,3.16475E-06,112,0.00030132,112
ลิ้น,41,0.000132919,0,2.66655E-06,41
ลิป,17,5.69655E-05,0,2.66655E-06,17
ลี,29,9.49424E-05,0,2.66655E-06,29
ลี่,34,0.000110766,0,2.66655E-06,34
ลีดเดอร์,11,3.7977E-05,0,2.66655E-06,11
ลีลา,10,3.48122E-05,0,2.66655E-06,10
ลึก,22,7.27892E-05,61,0.000165326,83
ลืม,132,0.000420911,79,0.000213324,211
ลือ,10,3.48122E-05,12,3.46651E-05,22
ลุ,10,3.48122E-05,0,2.66655E-06,10
ลุก,23,7.59539E-05,0,2.66655E-06,23
ลุกลาม,0,3.16475E-06,30,8.26629E-05,30
ลุค,21,6.96244E-05,0,2.66655E-06,21
ลุง,70,0.000224697,362,0.000967956,432
ลุ้น,54,0.000174061,13,3.73316E-05,67
ลุย,25,8.22834E-05,36,9.86622E-05,61
ลูก,302,0.000958918,113,0.000303986,415
ลูกกก,26,8.54482E-05,22,6.13306E-05,48
ลูกค้า,115,0.000367111,0,2.66655E-06,115
ลูกชาย,32,0.000104437,0,2.66655E-06,32
ลูกชิ้น,15,5.0636E-05,0,2.66655E-06,15
ลูกเธอ,0,3.16475E-06,29,7.99964E-05,29
ลูกน้อง,0,3.16475E-06,47,0.000127994,47
ลูกบอล,31,0.000101272,0,2.66655E-06,31
ลูกผู้ชาย,47,0.000151908,0,2.66655E-06,47
ลูกสาว,13,4.43065E-05,0,2.66655E-06,13
ลูกหลาน,0,3.16475E-06,31,8.53295E-05,31
เล,14,4.74712E-05,0,2.66655E-06,14
เลข,10,3.48122E-05,0,2.66655E-06,10
เลขที่,0,3.16475E-06,16,4.53313E-05,16
เล็ง,0,3.16475E-06,18,5.06644E-05,18
เล็งเห็น,0,3.16475E-06,26,7.19967E-05,26
เลเซอร์,10,3.48122E-05,0,2.66655E-06,10
เลน,22,7.27892E-05,0,2.66655E-06,22
เล่น,272,0.000863976,60,0.000162659,332
เลนส์,10,3.48122E-05,58,0.000157326,68
เล็บ,29,9.49424E-05,0,2.66655E-06,29
เล่ม,18,6.01302E-05,0,2.66655E-06,18
เล้ย,17,5.69655E-05,0,2.66655E-06,17
เลว,0,3.16475E-06,65,0.000175992,65
เลวร้าย,0,3.16475E-06,14,3.99982E-05,14
เละ,26,8.54482E-05,31,8.53295E-05,57
เลา,22,7.27892E-05,0,2.66655E-06,22
เล่า,23,7.59539E-05,33,9.06626E-05,56
เลิก,72,0.000231027,87,0.000234656,159
เลิกงาน,18,6.01302E-05,0,2.66655E-06,18
เลิฟ,25,8.22834E-05,0,2.66655E-06,25
เลิศ,0,3.16475E-06,68,0.000183992,68
เลีย,102,0.000325969,0,2.66655E-06,102
เลี่ยง,0,3.16475E-06,28,7.73298E-05,28
เลี้ยง,55,0.000177226,16,4.53313E-05,71
เลียนแบบ,0,3.16475E-06,14,3.99982E-05,14
เลียบพระนคร,0,3.16475E-06,37,0.000101329,37
เลือก,124,0.000395593,127,0.000341318,251
เลือกตั้ง,0,3.16475E-06,27,7.46633E-05,27
เลือกตั้งซ่อม,0,3.16475E-06,14,3.99982E-05,14
เลือด,18,6.01302E-05,100,0.000269321,118
เลือดเนื้อ,0,3.16475E-06,38,0.000103995,38
เลื่อน,27,8.86129E-05,25,6.93302E-05,52
แล,33,0.000107601,15,4.26647E-05,48
แล้,45,0.000145578,56,0.000151993,101
แลก,77,0.00024685,10,2.9332E-05,87
แลกเปลี่ยน,0,3.16475E-06,30,8.26629E-05,30
แล้ง,0,3.16475E-06,78,0.000210657,78
แลนด์,10,3.48122E-05,0,2.66655E-06,10
แล้วก็,89,0.000284827,24,6.66636E-05,113
โล,19,6.32949E-05,0,2.66655E-06,19
โล่,16,5.38007E-05,16,4.53313E-05,32
โลก,134,0.000427241,140,0.000375983,274
โลโก้,10,3.48122E-05,0,2.66655E-06,10
โลง,0,3.16475E-06,10,2.9332E-05,10
โล่ง,11,3.7977E-05,0,2.66655E-06,11
โลหิต,0,3.16475E-06,192,0.000514643,192
ไล่,28,9.17777E-05,46,0.000125328,74
ไลค์,12,4.11417E-05,0,2.66655E-06,12
ไลน์,255,0.000810175,17,4.79978E-05,272
ไลฟ์,43,0.000139249,10,2.9332E-05,53
ว,278,0.000882964,53,0.000143993,331
ว.,15,5.0636E-05,0,2.66655E-06,15
วก,55,0.000177226,0,2.66655E-06,55
วง,86,0.000275333,11,3.19985E-05,97
วงการ,37,0.00012026,15,4.26647E-05,52
วงใน,0,3.16475E-06,22,6.13306E-05,22
วงศ์,0,3.16475E-06,14,3.99982E-05,14
วงศ์วาน,19,6.32949E-05,0,2.66655E-06,19
วจะ,59,0.000189885,30,8.26629E-05,89
วดี,13,4.43065E-05,30,8.26629E-05,43
วต,11,3.7977E-05,0,2.66655E-06,11
วน,50,0.000161402,32,8.7996E-05,82
วร,0,3.16475E-06,10,2.9332E-05,10
วรงค์,0,3.16475E-06,20,5.59975E-05,20
วรรค,0,3.16475E-06,10,2.9332E-05,10
วว,82,0.000262674,10,2.9332E-05,92
ววว,65,0.000208873,10,2.9332E-05,75
วววว,51,0.000164567,0,2.66655E-06,51
ววววว,24,7.91187E-05,0,2.66655E-06,24
วอ,22,7.27892E-05,0,2.66655E-06,22
วอน,27,8.86129E-05,17,4.79978E-05,44
ว่อน,20,6.64597E-05,0,2.66655E-06,20
ว้อย,22,7.27892E-05,0,2.66655E-06,22
วอร์,71,0.000227862,0,2.66655E-06,71
วะ,145,0.000462053,70,0.000189325,215
ว่ะ,108,0.000344957,38,0.000103995,146
วัง,44,0.000142414,26,7.19967E-05,70
วัชร,0,3.16475E-06,25,6.93302E-05,25
วัฒน,0,3.16475E-06,74,0.000199991,74
วัฒนธรรม,0,3.16475E-06,17,4.79978E-05,17
วัฒนะ,24,7.91187E-05,0,2.66655E-06,24
วัฒนา,0,3.16475E-06,20,5.59975E-05,20
วัด,189,0.000601302,148,0.000397315,337
วันเกิด,70,0.000224697,0,2.66655E-06,70
วันครู,0,3.16475E-06,18,5.06644E-05,18
วันคล้ายวันพระราชสมภพ,10,3.48122E-05,13,3.73316E-05,23
วันดี,14,4.74712E-05,0,2.66655E-06,14
วันที่,258,0.00081967,316,0.000845295,574
วันพระ,24,7.91187E-05,0,2.66655E-06,24
วันพรุ่งนี้,14,4.74712E-05,0,2.66655E-06,14
วันสุดท้าย,10,3.48122E-05,15,4.26647E-05,25
วันหยุด,85,0.000272168,20,5.59975E-05,105
วันอาทิตย์,20,6.64597E-05,0,2.66655E-06,20
วัย,21,6.96244E-05,30,8.26629E-05,51
วัยรุ่น,13,4.43065E-05,0,2.66655E-06,13
วัว,18,6.01302E-05,0,2.66655E-06,18
วัส,0,3.16475E-06,17,4.79978E-05,17
วา,55,0.000177226,65,0.000175992,120
ว่าการ,0,3.16475E-06,56,0.000151993,56
วาง,24,7.91187E-05,45,0.000122661,69
ว่าง,237,0.00075321,12,3.46651E-05,249
วาด,23,7.59539E-05,0,2.66655E-06,23
วาดรูป,11,3.7977E-05,0,2.66655E-06,11
ว่าด้วย,0,3.16475E-06,13,3.73316E-05,13
ว่าแต่,12,4.11417E-05,0,2.66655E-06,12
ว่าที่,11,3.7977E-05,18,5.06644E-05,29
วาน,0,3.16475E-06,29,7.99964E-05,29
วาย,21,6.96244E-05,0,2.66655E-06,21
วายชนม์,0,3.16475E-06,27,7.46633E-05,27
วาร,10,3.48122E-05,0,2.66655E-06,10
วาระ,0,3.16475E-06,21,5.8664E-05,21
วาเลนไทน์,0,3.16475E-06,24,6.66636E-05,24
ว่าแล้ว,10,3.48122E-05,10,2.9332E-05,20
ว่าว,13,4.43065E-05,0,2.66655E-06,13
ว้าว,45,0.000145578,16,4.53313E-05,61
วาสนา,0,3.16475E-06,15,4.26647E-05,15
วิ,65,0.000208873,48,0.000130661,113
วิกฤต,0,3.16475E-06,55,0.000149327,55
วิกฤติ,0,3.16475E-06,15,4.26647E-05,15
วิเคราะห์,0,3.16475E-06,19,5.33309E-05,19
วิ่ง,101,0.000322804,86,0.000231989,187
วิ่งกระสอบ,0,3.16475E-06,13,3.73316E-05,13
วิ่งราว,0,3.16475E-06,18,5.06644E-05,18
วิ่งไล่,0,3.16475E-06,82,0.000221323,82
วิจัย,10,3.48122E-05,0,2.66655E-06,10
วิจาร,0,3.16475E-06,11,3.19985E-05,11
วิจารณ์,0,3.16475E-06,32,8.7996E-05,32
วิชา,0,3.16475E-06,26,7.19967E-05,26
วิชิต,0,3.16475E-06,10,2.9332E-05,10
วิดีโอ,13,4.43065E-05,0,2.66655E-06,13
วิถี,10,3.48122E-05,27,7.46633E-05,37
วิทย์,0,3.16475E-06,14,3.99982E-05,14
วิทยา,0,3.16475E-06,36,9.86622E-05,36
วิทยากร,0,3.16475E-06,14,3.99982E-05,14
วิทยาลัย,0,3.16475E-06,15,4.26647E-05,15
วิธี,17,5.69655E-05,143,0.000383983,160
วิธีการ,0,3.16475E-06,16,4.53313E-05,16
วิน,183,0.000582313,0,2.66655E-06,183
วินัย,0,3.16475E-06,21,5.8664E-05,21
วินาที,10,3.48122E-05,38,0.000103995,48
วินิจฉัย,0,3.16475E-06,23,6.39971E-05,23
วิว,51,0.000164567,0,2.66655E-06,51
วิวัฒน์,0,3.16475E-06,18,5.06644E-05,18
วิษณุ,0,3.16475E-06,13,3.73316E-05,13
วิสามัญ,0,3.16475E-06,26,7.19967E-05,26
วี,23,7.59539E-05,14,3.99982E-05,37
วีค,16,5.38007E-05,0,2.66655E-06,16
วีร,16,5.38007E-05,34,9.33291E-05,50
วีรบุรุษ,0,3.16475E-06,28,7.73298E-05,28
วีระ,0,3.16475E-06,11,3.19985E-05,11
วุฒิ,17,5.69655E-05,0,2.66655E-06,17
วุ่นวาย,16,5.38007E-05,53,0.000143993,69
วุ่ยวาย,0,3.16475E-06,30,8.26629E-05,30
เว,0,3.16475E-06,14,3.99982E-05,14
เวชกรรม,0,3.16475E-06,27,7.46633E-05,27
เวท,14,4.74712E-05,0,2.66655E-06,14
เวที,24,7.91187E-05,33,9.06626E-05,57
เวน,11,3.7977E-05,0,2.66655E-06,11
เว้น,0,3.16475E-06,13,3.73316E-05,13
เวบ,0,3.16475E-06,10,2.9332E-05,10
เว็บ,13,4.43065E-05,0,2.66655E-06,13
เวบไซต์,0,3.16475E-06,10,2.9332E-05,10
เว็บไซต์,0,3.16475E-06,13,3.73316E-05,13
เว้ย,28,9.17777E-05,0,2.66655E-06,28
เวร,29,9.49424E-05,18,5.06644E-05,47
เวลา,306,0.000971577,358,0.00095729,664
เวลานี้,12,4.11417E-05,13,3.73316E-05,25
เวส,0,3.16475E-06,23,6.39971E-05,23
เว่อ,11,3.7977E-05,0,2.66655E-06,11
เวอร์,11,3.7977E-05,0,2.66655E-06,11
เวียง,0,3.16475E-06,10,2.9332E-05,10
เวียดนาม,14,4.74712E-05,0,2.66655E-06,14
แว้,11,3.7977E-05,0,2.66655E-06,11
แว้ว,11,3.7977E-05,0,2.66655E-06,11
แวะ,86,0.000275333,11,3.19985E-05,97
โว้ย,50,0.000161402,0,2.66655E-06,50
โวยวาย,0,3.16475E-06,13,3.73316E-05,13
ไว,80,0.000256345,51,0.00013866,131
ไวรัส,0,3.16475E-06,658,0.001757254,658
ไว้วางใจ,0,3.16475E-06,44,0.000119995,44
ไว้อาลัย,0,3.16475E-06,93,0.000250655,93
ศ,13,4.43065E-05,0,2.66655E-06,13
ศบภ.ม,0,3.16475E-06,14,3.99982E-05,14
ศพ,0,3.16475E-06,42,0.000114661,42
ศรัทธา,12,4.11417E-05,15,4.26647E-05,27
ศรี,26,8.54482E-05,122,0.000327985,148
ศรีนครินทร์,42,0.000136084,0,2.66655E-06,42
ศรีราชา,20,6.64597E-05,0,2.66655E-06,20
ศรีสุวรรณ,0,3.16475E-06,16,4.53313E-05,16
ศักดิ์,0,3.16475E-06,51,0.00013866,51
ศักยภาพ,0,3.16475E-06,12,3.46651E-05,12
ศาล,0,3.16475E-06,209,0.000559975,209
ศาลฎีกา,0,3.16475E-06,10,2.9332E-05,10
ศาลรัฐธรรมนูญ,0,3.16475E-06,84,0.000226656,84
ศาลา,17,5.69655E-05,0,2.66655E-06,17
ศาสตร์,0,3.16475E-06,11,3.19985E-05,11
ศาสน์,146,0.000465218,128,0.000343984,274
ศาสนา,0,3.16475E-06,25,6.93302E-05,25
ศิ,26,8.54482E-05,80,0.00021599,106
ศิค,12,4.11417E-05,0,2.66655E-06,12
ศิลป์,0,3.16475E-06,24,6.66636E-05,24
ศิลปิน,42,0.000136084,0,2.66655E-06,42
ศิษย์,0,3.16475E-06,12,3.46651E-05,12
ศึ…,0,3.16475E-06,11,3.19985E-05,11
ศึก,0,3.16475E-06,31,8.53295E-05,31
ศึกษา,17,5.69655E-05,39,0.000106662,56
ศูนย์,27,8.86129E-05,202,0.000541309,229
ศูนย์การค้า,0,3.16475E-06,21,5.8664E-05,21
ศูนย์บัญชาการ,0,3.16475E-06,26,7.19967E-05,26
เศรษฐกิจ,0,3.16475E-06,66,0.000178659,66
เศร้า,27,8.86129E-05,31,8.53295E-05,58
โศกนาฏกรรม,0,3.16475E-06,36,9.86622E-05,36
ษ,11,3.7977E-05,0,2.66655E-06,11
ษฎ…,0,3.16475E-06,11,3.19985E-05,11
ษา,11,3.7977E-05,0,2.66655E-06,11
ส์,15,5.0636E-05,0,2.66655E-06,15
ส,249,0.000791187,67,0.000181325,316
ส.ว.,0,3.16475E-06,20,5.59975E-05,20
ส.ส.,0,3.16475E-06,145,0.000389316,145
ส.อ.,0,3.16475E-06,10,2.9332E-05,10
"ส…""",0,3.16475E-06,31,8.53295E-05,31
สกปรก,0,3.16475E-06,10,2.9332E-05,10
สกลนคร,11,3.7977E-05,0,2.66655E-06,11
สกัด,0,3.16475E-06,19,5.33309E-05,19
สกัดกั้น,0,3.16475E-06,52,0.000141327,52
สกาย,0,3.16475E-06,11,3.19985E-05,11
สแกน,10,3.48122E-05,0,2.66655E-06,10
สงกรานต์,0,3.16475E-06,28,7.73298E-05,28
สงขลา,27,8.86129E-05,12,3.46651E-05,39
สงคราม,0,3.16475E-06,38,0.000103995,38
ส่งต่อ,34,0.000110766,0,2.66655E-06,34
สงบ,0,3.16475E-06,41,0.000111995,41
สงบสุข,0,3.16475E-06,15,4.26647E-05,15
ส่งผล,0,3.16475E-06,20,5.59975E-05,20
สงสัย,43,0.000139249,46,0.000125328,89
สงสาร,36,0.000117096,20,5.59975E-05,56
ส่งเสริม,0,3.16475E-06,43,0.000117328,43
สด,103,0.000329134,31,8.53295E-05,134
สดชื่น,19,6.32949E-05,0,2.66655E-06,19
สดใส,29,9.49424E-05,11,3.19985E-05,40
สดุดี,0,3.16475E-06,46,0.000125328,46
สต,31,0.000101272,0,2.66655E-06,31
สตช.,0,3.16475E-06,13,3.73316E-05,13
สตอ,22,7.27892E-05,0,2.66655E-06,22
สติ,0,3.16475E-06,42,0.000114661,42
สไตล์,0,3.16475E-06,12,3.46651E-05,12
สถาน,0,3.16475E-06,29,7.99964E-05,29
สถานการณ์,15,5.0636E-05,178,0.000477312,193
สถานที่,68,0.000218368,23,6.39971E-05,91
สถานะ,0,3.16475E-06,10,2.9332E-05,10
สถานี,0,3.16475E-06,39,0.000106662,39
สถาบัน,17,5.69655E-05,71,0.000191991,88
สถิต,35,0.000113931,0,2.66655E-06,35
สถิติ,0,3.16475E-06,10,2.9332E-05,10
สธ,0,3.16475E-06,41,0.000111995,41
สน,39,0.00012659,16,4.53313E-05,55
สนใจ,300,0.000952589,52,0.000141327,352
ส้นตีน,0,3.16475E-06,39,0.000106662,39
สนับสนุน,22,7.27892E-05,213,0.000570641,235
สนาม,16,5.38007E-05,45,0.000122661,61
สนามกอล์ฟ,0,3.16475E-06,14,3.99982E-05,14
สนามบิน,10,3.48122E-05,29,7.99964E-05,39
สนามหลวง,20,6.64597E-05,0,2.66655E-06,20
สนิท,17,5.69655E-05,0,2.66655E-06,17
สนุก,132,0.000420911,16,4.53313E-05,148
สบายใจ,30,9.81072E-05,24,6.66636E-05,54
สปริง,0,3.16475E-06,121,0.000325319,121
สปา,52,0.000167732,0,2.66655E-06,52
สผั่ส,0,3.16475E-06,17,4.79978E-05,17
สภา,0,3.16475E-06,218,0.000583974,218
สภาพ,21,6.96244E-05,39,0.000106662,60
สม,24,7.91187E-05,141,0.00037865,165
ส้ม,26,8.54482E-05,176,0.000471979,202
สมควร,0,3.16475E-06,77,0.000207991,77
สมเด็จ,29,9.49424E-05,162,0.000434647,191
สมเด็จพระกนิษฐาธิราชเจ้า กรมสมเด็จพระเทพรัตนราชสุดาฯ สยามบรมราชกุมารี,0,3.16475E-06,85,0.000229323,85
สมเด็จพระนางเจ้า,0,3.16475E-06,19,5.33309E-05,19
ส้มตำ,19,6.32949E-05,0,2.66655E-06,19
สมภพ,24,7.91187E-05,0,2.66655E-06,24
สมรรถ,0,3.16475E-06,11,3.19985E-05,11
สมรรถภาพ,0,3.16475E-06,30,8.26629E-05,30
สมหมาย,0,3.16475E-06,21,5.8664E-05,21
สมหวัง,12,4.11417E-05,0,2.66655E-06,12
สมอง,29,9.49424E-05,95,0.000255988,124
สมัคร,41,0.000132919,31,8.53295E-05,72
สมา,17,5.69655E-05,0,2.66655E-06,17
สมาคม,0,3.16475E-06,52,0.000141327,52
สมาชิก,0,3.16475E-06,15,4.26647E-05,15
สมาส,10,3.48122E-05,0,2.66655E-06,10
สมุทรปราการ,31,0.000101272,0,2.66655E-06,31
สมุทรสาคร,21,6.96244E-05,0,2.66655E-06,21
สยาม,51,0.000164567,27,7.46633E-05,78
สร,11,3.7977E-05,0,2.66655E-06,11
สรรหา,11,3.7977E-05,0,2.66655E-06,11
สระ,14,4.74712E-05,23,6.39971E-05,37
สระแก้ว,0,3.16475E-06,46,0.000125328,46
สระน้ำ,0,3.16475E-06,11,3.19985E-05,11
สระบุรี,33,0.000107601,0,2.66655E-06,33
สร้าง,57,0.000183555,481,0.001285275,538
สร้างชาติ,0,3.16475E-06,17,4.79978E-05,17
สร้างบ้าน,0,3.16475E-06,10,2.9332E-05,10
สร้างภาพ,10,3.48122E-05,17,4.79978E-05,27
สร้างเรื่อง,0,3.16475E-06,24,6.66636E-05,24
สร้างสรรค์,0,3.16475E-06,20,5.59975E-05,20
สรุป,66,0.000212038,69,0.000186658,135
สละ,0,3.16475E-06,41,0.000111995,41
สลับ,20,6.64597E-05,0,2.66655E-06,20
สลิ่ม,37,0.00012026,43,0.000117328,80
สไลด์,10,3.48122E-05,0,2.66655E-06,10
สว,0,3.16475E-06,12,3.46651E-05,12
สวน,88,0.000281663,35,9.59956E-05,123
ส่วนกุศล,0,3.16475E-06,46,0.000125328,46
ส่วนตัว,66,0.000212038,32,8.7996E-05,98
ส่วนรวม,0,3.16475E-06,36,9.86622E-05,36
ส่วนราชการ,0,3.16475E-06,44,0.000119995,44
ส่วนลด,32,0.000104437,0,2.66655E-06,32
สวนสนาม,0,3.16475E-06,15,4.26647E-05,15
สวนสาธารณะ,0,3.16475E-06,14,3.99982E-05,14
สวนหย่อม,0,3.16475E-06,11,3.19985E-05,11
สวม,0,3.16475E-06,16,4.53313E-05,16
สวมหน้ากาก,0,3.16475E-06,14,3.99982E-05,14
สวย,444,0.001408313,79,0.000213324,523
สวยงาม,28,9.17777E-05,58,0.000157326,86
สวรรค์,10,3.48122E-05,0,2.66655E-06,10
สวะ,0,3.16475E-06,68,0.000183992,68
สวัสดิ,0,3.16475E-06,36,9.86622E-05,36
สวัสดิการ,0,3.16475E-06,72,0.000194658,72
สวัสดี,85,0.000272168,55,0.000149327,140
สวาง,0,3.16475E-06,11,3.19985E-05,11
สวาย,0,3.16475E-06,10,2.9332E-05,10
สวิง,22,7.27892E-05,0,2.66655E-06,22
สวิงกิ้ง,28,9.17777E-05,0,2.66655E-06,28
สส,10,3.48122E-05,48,0.000130661,58
สส.,10,3.48122E-05,41,0.000111995,51
สสส,26,8.54482E-05,0,2.66655E-06,26
สห,29,9.49424E-05,0,2.66655E-06,29
สหรัฐ,0,3.16475E-06,26,7.19967E-05,26
สหรัฐอเมริกา,0,3.16475E-06,26,7.19967E-05,26
สหรัฐฯ,0,3.16475E-06,157,0.000421314,157
ส่อ,0,3.16475E-06,19,5.33309E-05,19
สอง,472,0.001496925,72,0.000194658,544
ส่อง,40,0.000129755,0,2.66655E-06,40
สอด,12,4.11417E-05,18,5.06644E-05,30
สอน,58,0.00018672,45,0.000122661,103
สอนพิเศษ,10,3.48122E-05,0,2.66655E-06,10
สอบ,49,0.000158237,52,0.000141327,101
สอบถาม,61,0.000196214,12,3.46651E-05,73
สอบสวน,0,3.16475E-06,22,6.13306E-05,22
สะ,14,4.74712E-05,32,8.7996E-05,46
สะใจ,17,5.69655E-05,0,2.66655E-06,17
สะดวก,30,9.81072E-05,15,4.26647E-05,45
สะท้อน,0,3.16475E-06,48,0.000130661,48
สะพาน,69,0.000221532,65,0.000175992,134
สะพาย,10,3.48122E-05,0,2.66655E-06,10
สะสม,22,7.27892E-05,12,3.46651E-05,34
สะอาด,12,4.11417E-05,0,2.66655E-06,12
สัก,102,0.000325969,52,0.000141327,154
สักครั้ง,12,4.11417E-05,0,2.66655E-06,12
สักที,46,0.000148743,28,7.73298E-05,74
สักพัก,16,5.38007E-05,0,2.66655E-06,16
สักวัน,14,4.74712E-05,0,2.66655E-06,14
สักหน่อย,13,4.43065E-05,0,2.66655E-06,13
สั่ง,140,0.000446229,153,0.000410648,293
สังกัด,0,3.16475E-06,20,5.59975E-05,20
สั่งการ,0,3.16475E-06,58,0.000157326,58
สังคม,21,6.96244E-05,140,0.000375983,161
สั่งซื้อ,20,6.64597E-05,0,2.66655E-06,20
สังหาร,0,3.16475E-06,12,3.46651E-05,12
สัญญา,19,6.32949E-05,21,5.8664E-05,40
สัญลักษณ์,0,3.16475E-06,37,0.000101329,37
สัด,16,5.38007E-05,0,2.66655E-06,16
สัตว์,13,4.43065E-05,12,3.46651E-05,25
สัตหีบ,112,0.000357616,13,3.73316E-05,125
สัน,34,0.000110766,0,2.66655E-06,34
สั่น,30,9.81072E-05,0,2.66655E-06,30
สันดาน,13,4.43065E-05,13,3.73316E-05,26
สันติ,24,7.91187E-05,0,2.66655E-06,24
สันติภาพ,0,3.16475E-06,14,3.99982E-05,14
สับ,12,4.11417E-05,0,2.66655E-06,12
สัปดาห์,27,8.86129E-05,21,5.8664E-05,48
สัมผัส,17,5.69655E-05,10,2.9332E-05,27
สัมพันธ์,0,3.16475E-06,43,0.000117328,43
สัมภาษณ์,0,3.16475E-06,25,6.93302E-05,25
สัส,58,0.00018672,22,6.13306E-05,80
สา,18,6.01302E-05,68,0.000183992,86
สํา,14,4.74712E-05,0,2.66655E-06,14
สาขา,22,7.27892E-05,24,6.66636E-05,46
สาทร,12,4.11417E-05,0,2.66655E-06,12
สาธยาย,13,4.43065E-05,0,2.66655E-06,13
สาธารณภัย,0,3.16475E-06,133,0.000357317,133
สาธารณสุข,0,3.16475E-06,19,5.33309E-05,19
สาธารณะ,0,3.16475E-06,38,0.000103995,38
สาธุ,44,0.000142414,38,0.000103995,82
สาน,0,3.16475E-06,29,7.99964E-05,29
สาม,81,0.000259509,21,5.8664E-05,102
สามย่าน,11,3.7977E-05,0,2.66655E-06,11
สามัคคี,0,3.16475E-06,17,4.79978E-05,17
สามี,12,4.11417E-05,0,2.66655E-06,12
สาย,188,0.000598137,300,0.00080263,488
สายด่วน,0,3.16475E-06,10,2.9332E-05,10
สายตา,53,0.000170896,0,2.66655E-06,53
สายพันธุ์,0,3.16475E-06,130,0.000349317,130
สายใย,0,3.16475E-06,18,5.06644E-05,18
สาร,15,5.0636E-05,44,0.000119995,59
สารวัตร,0,3.16475E-06,17,4.79978E-05,17
สาระ,0,3.16475E-06,16,4.53313E-05,16
สาว,635,0.002012779,20,5.59975E-05,655
สาวก,0,3.16475E-06,11,3.19985E-05,11
สาวน้อย,33,0.000107601,0,2.66655E-06,33
สาวใหญ่,24,7.91187E-05,0,2.66655E-06,24
สาเหตุ,11,3.7977E-05,16,4.53313E-05,27
สำ,0,3.16475E-06,52,0.000141327,52
สำนัก,0,3.16475E-06,35,9.59956E-05,35
สำนักข่าว,0,3.16475E-06,12,3.46651E-05,12
สำนักงาน,0,3.16475E-06,15,4.26647E-05,15
สำนักงานตำรวจแห่งชาติ,0,3.16475E-06,11,3.19985E-05,11
สำนึก,17,5.69655E-05,43,0.000117328,60
สำรวจ,13,4.43065E-05,37,0.000101329,50
สำราญ,0,3.16475E-06,69,0.000186658,69
สำเร็จ,19,6.32949E-05,18,5.06644E-05,37
สำโรง,15,5.0636E-05,0,2.66655E-06,15
สำหรับ,122,0.000389264,112,0.00030132,234
สิ,239,0.000759539,211,0.000565308,450
สิง,15,5.0636E-05,12,3.46651E-05,27
สิงคโปร์,0,3.16475E-06,31,8.53295E-05,31
สิงโต,19,6.32949E-05,0,2.66655E-06,19
สิ่งผิดกฎหมาย,0,3.16475E-06,11,3.19985E-05,11
สิงหนาท,0,3.16475E-06,12,3.46651E-05,12
สิงห์บุรี,0,3.16475E-06,10,2.9332E-05,10
สิทธิ์,18,6.01302E-05,0,2.66655E-06,18
สิทธิ,12,4.11417E-05,75,0.000202657,87
สิน,0,3.16475E-06,10,2.9332E-05,10
สินค้า,53,0.000170896,20,5.59975E-05,73
สิ้นปี,22,7.27892E-05,0,2.66655E-06,22
สิบ,24,7.91187E-05,13,3.73316E-05,37
สิบเอก,0,3.16475E-06,23,6.39971E-05,23
สิริ,0,3.16475E-06,35,9.59956E-05,35
สิว,50,0.000161402,0,2.66655E-06,50
สี,176,0.00056016,82,0.000221323,258
สี่,56,0.000180391,0,2.66655E-06,56
สีแดง,0,3.16475E-06,28,7.73298E-05,28
สีผม,17,5.69655E-05,0,2.66655E-06,17
สีม่วง,10,3.48122E-05,0,2.66655E-06,10
สีส้ม,0,3.16475E-06,30,8.26629E-05,30
สึก,10,3.48122E-05,0,2.66655E-06,10
สืบ,0,3.16475E-06,10,2.9332E-05,10
สื่อ,11,3.7977E-05,234,0.000626638,245
สื่อมวลชน,0,3.16475E-06,16,4.53313E-05,16
สื่อสาร,0,3.16475E-06,21,5.8664E-05,21
สุ,31,0.000101272,68,0.000183992,99
สุกี้,11,3.7977E-05,0,2.66655E-06,11
สุข,77,0.00024685,43,0.000117328,120
สุขภาพ,65,0.000208873,115,0.000309319,180
สุขสันต์,46,0.000148743,0,2.66655E-06,46
สุขสันต์วันเกิด,17,5.69655E-05,0,2.66655E-06,17
สุขุมวิท,25,8.22834E-05,0,2.66655E-06,25
สุโขทัย,30,9.81072E-05,0,2.66655E-06,30
สุดซึ้ง,0,3.16475E-06,10,2.9332E-05,10
สุดท้าย,103,0.000329134,41,0.000111995,144
สุดยอด,65,0.000208873,292,0.000781298,357
สุดสัปดาห์,0,3.16475E-06,16,4.53313E-05,16
สุนัข,0,3.16475E-06,10,2.9332E-05,10
สุพรรณบุรี,12,4.11417E-05,0,2.66655E-06,12
สุพรรณหงส์,0,3.16475E-06,13,3.73316E-05,13
สุ่ม,51,0.000164567,0,2.66655E-06,51
สุร,0,3.16475E-06,25,6.93302E-05,25
สุรนารี,0,3.16475E-06,41,0.000111995,41
สุรยุทธ์,0,3.16475E-06,14,3.99982E-05,14
สุรศักดิ์มนตรี,0,3.16475E-06,82,0.000221323,82
สุรสีห์,0,3.16475E-06,19,5.33309E-05,19
สุรินทร์,0,3.16475E-06,15,4.26647E-05,15
สุวรรณ,0,3.16475E-06,12,3.46651E-05,12
สุวรรณภูมิ,40,0.000129755,0,2.66655E-06,40
สู,10,3.48122E-05,15,4.26647E-05,25
สู้,145,0.000462053,420,0.001122616,565
สู้คดี,0,3.16475E-06,22,6.13306E-05,22
สูญ,0,3.16475E-06,15,4.26647E-05,15
สูญเสีย,0,3.16475E-06,153,0.000410648,153
สูตร,33,0.000107601,0,2.66655E-06,33
เส,25,8.22834E-05,76,0.000205324,101
เสด,14,4.74712E-05,0,2.66655E-06,14
เสด็จ,10,3.48122E-05,65,0.000175992,75
เสด็จพระราชดำเนิน,0,3.16475E-06,97,0.000261321,97
เสธ.,0,3.16475E-06,59,0.000159993,59
เส้น,70,0.000224697,0,2.66655E-06,70
เส้นทาง,0,3.16475E-06,37,0.000101329,37
เสนอ,11,3.7977E-05,78,0.000210657,89
เสนาธิการ,0,3.16475E-06,22,6.13306E-05,22
เสพ,0,3.16475E-06,46,0.000125328,46
เสมอ,97,0.000310145,34,9.33291E-05,131
เสมอมา,0,3.16475E-06,17,4.79978E-05,17
เสริม,25,8.22834E-05,31,8.53295E-05,56
เสรี,0,3.16475E-06,93,0.000250655,93
เสรีภาพ,0,3.16475E-06,12,3.46651E-05,12
เสวนา,0,3.16475E-06,17,4.79978E-05,17
เสา,0,3.16475E-06,15,4.26647E-05,15
เส้า,13,4.43065E-05,0,2.66655E-06,13
เสาธง,0,3.16475E-06,14,3.99982E-05,14
เสียง,94,0.000300651,67,0.000181325,161
เสี่ยง,0,3.16475E-06,62,0.000167992,62
เสียงดัง,16,5.38007E-05,0,2.66655E-06,16
เสียใจ,48,0.000155073,100,0.000269321,148
เสียชีวิต,10,3.48122E-05,150,0.000402648,160
เสียดาย,53,0.000170896,44,0.000119995,97
เสียบ,55,0.000177226,28,7.73298E-05,83
เสียว,222,0.000705739,0,2.66655E-06,222
เสี่ยว,20,6.64597E-05,0,2.66655E-06,20
เสียเวลา,10,3.48122E-05,0,2.66655E-06,10
เสียสละ,0,3.16475E-06,86,0.000231989,86
เสียหาย,0,3.16475E-06,34,9.33291E-05,34
เสือ,35,0.000113931,10,2.9332E-05,45
เสื้อ,126,0.000401923,39,0.000106662,165
เสือก,17,5.69655E-05,37,0.000101329,54
เสื้อเกราะ,0,3.16475E-06,25,6.93302E-05,25
เสื้อผ้า,35,0.000113931,0,2.66655E-06,35
แสง,44,0.000142414,46,0.000125328,90
แสดงออก,0,3.16475E-06,19,5.33309E-05,19
แสน,109,0.000348122,55,0.000149327,164
แสนยากร,0,3.16475E-06,15,4.26647E-05,15
แสบ,16,5.38007E-05,0,2.66655E-06,16
โสด,58,0.00018672,0,2.66655E-06,58
ใส,72,0.000231027,16,4.53313E-05,88
ใส่,341,0.001082344,52,0.000141327,393
ใส่ใจ,17,5.69655E-05,115,0.000309319,132
ใส่ร้าย,0,3.16475E-06,21,5.8664E-05,21
ไส้,15,5.0636E-05,0,2.66655E-06,15
ห,53,0.000170896,24,6.66636E-05,77
ห…,0,3.16475E-06,34,9.33291E-05,34
"ห…""",0,3.16475E-06,49,0.000133327,49
หก,25,8.22834E-05,0,2.66655E-06,25
หงส์,10,3.48122E-05,0,2.66655E-06,10
หงุดหงิด,22,7.27892E-05,0,2.66655E-06,22
หญ้า,0,3.16475E-06,34,9.33291E-05,34
หญิง,70,0.000224697,76,0.000205324,146
หนวด,11,3.7977E-05,0,2.66655E-06,11
หน่วย,0,3.16475E-06,258,0.000690635,258
หน่วยงาน,0,3.16475E-06,152,0.000407982,152
หน่วยเฉพาะกิจ,0,3.16475E-06,118,0.000317319,118
หน่อ,10,3.48122E-05,0,2.66655E-06,10
หนอง,79,0.00025318,64,0.000173325,143
หนองคาย,0,3.16475E-06,16,4.53313E-05,16
หนัก,79,0.00025318,54,0.00014666,133
หนักแผ่นดิน,0,3.16475E-06,18,5.06644E-05,18
หนัง,186,0.000591808,39,0.000106662,225
หนังสือ,39,0.00012659,26,7.19967E-05,65
หนา,18,6.01302E-05,0,2.66655E-06,18
หน้า,374,0.00118678,205,0.000549308,579
หน้ากาก,31,0.000101272,269,0.000719967,300
หน้าจอ,37,0.00012026,18,5.06644E-05,55
หน้าตา,19,6.32949E-05,17,4.79978E-05,36
หน้าที่,27,8.86129E-05,55,0.000149327,82
หน้าบ้าน,15,5.0636E-05,0,2.66655E-06,15
หน้าไฟ,0,3.16475E-06,29,7.99964E-05,29
หนาว,132,0.000420911,80,0.00021599,212
หน้าหนาว,21,6.96244E-05,0,2.66655E-06,21
หน้าอก,10,3.48122E-05,0,2.66655E-06,10
หนี,39,0.00012659,43,0.000117328,82
หนี้,0,3.16475E-06,12,3.46651E-05,12
หนีบ,15,5.0636E-05,0,2.66655E-06,15
หนึบ,13,4.43065E-05,0,2.66655E-06,13
หนุน,0,3.16475E-06,53,0.000143993,53
หนุ่ม,57,0.000183555,24,6.66636E-05,81
หนุมาน,0,3.16475E-06,135,0.00036265,135
หนู,259,0.000822834,52,0.000141327,311
"หม…""",0,3.16475E-06,13,3.73316E-05,13
หมวก,0,3.16475E-06,15,4.26647E-05,15
หมวด,0,3.16475E-06,12,3.46651E-05,12
หมวย,20,6.64597E-05,0,2.66655E-06,20
หมอ,108,0.000344957,132,0.000354651,240
หมอก,14,4.74712E-05,13,3.73316E-05,27
หมอน,11,3.7977E-05,0,2.66655E-06,11
หม่อน,14,4.74712E-05,0,2.66655E-06,14
หมอนวด,20,6.64597E-05,0,2.66655E-06,20
หม่อมฉัน,0,3.16475E-06,10,2.9332E-05,10
หมา,75,0.000240521,65,0.000175992,140
หม่า,36,0.000117096,0,2.66655E-06,36
หมาย,0,3.16475E-06,79,0.000213324,79
หมายถึง,24,7.91187E-05,49,0.000133327,73
หมิ่น,0,3.16475E-06,10,2.9332E-05,10
หมิ่นประมาท,0,3.16475E-06,12,3.46651E-05,12
หมี,60,0.00019305,0,2.66655E-06,60
หมื่น,28,9.17777E-05,53,0.000143993,81
หมู,92,0.000294321,18,5.06644E-05,110
หมู่,27,8.86129E-05,42,0.000114661,69
หมูกรอบ,10,3.48122E-05,0,2.66655E-06,10
หมู่บ้าน,22,7.27892E-05,21,5.8664E-05,43
หมูยอ,13,4.43065E-05,0,2.66655E-06,13
หยัง,19,6.32949E-05,10,2.9332E-05,29
หยิ่ง,17,5.69655E-05,0,2.66655E-06,17
หยิ่น,20,6.64597E-05,0,2.66655E-06,20
หยิบ,14,4.74712E-05,12,3.46651E-05,26
หยุด,114,0.000363946,165,0.000442647,279
หรอ,226,0.000718398,162,0.000434647,388
หรอก,101,0.000322804,137,0.000367983,238
หรา,25,8.22834E-05,10,2.9332E-05,35
หรือว่า,12,4.11417E-05,0,2.66655E-06,12
หล…,0,3.16475E-06,13,3.73316E-05,13
หลง,29,9.49424E-05,16,4.53313E-05,45
หลงเชื่อ,0,3.16475E-06,29,7.99964E-05,29
หลบ,13,4.43065E-05,0,2.66655E-06,13
หลวง,32,0.000104437,145,0.000389316,177
หลวงพ่อ,15,5.0636E-05,0,2.66655E-06,15
หลอ,0,3.16475E-06,10,2.9332E-05,10
หล่อ,402,0.001275393,0,2.66655E-06,402
หลอก,29,9.49424E-05,75,0.000202657,104
หลอกลวง,0,3.16475E-06,10,2.9332E-05,10
หลอด,18,6.01302E-05,0,2.66655E-06,18
หลอดเลือด,0,3.16475E-06,18,5.06644E-05,18
หละ,13,4.43065E-05,0,2.66655E-06,13
หล่ะ,0,3.16475E-06,16,4.53313E-05,16
หละหลวม,0,3.16475E-06,14,3.99982E-05,14
หลัก,22,7.27892E-05,59,0.000159993,81
หลักฐาน,13,4.43065E-05,51,0.00013866,64
หลักสูตร,0,3.16475E-06,45,0.000122661,45
หลั่ง,0,3.16475E-06,16,4.53313E-05,16
หลังคา,0,3.16475E-06,60,0.000162659,60
หลังจากที่,0,3.16475E-06,20,5.59975E-05,20
หลั่งไหล,0,3.16475E-06,17,4.79978E-05,17
หลับ,62,0.000199379,11,3.19985E-05,73
หลับตา,14,4.74712E-05,0,2.66655E-06,14
หลากหลาย,0,3.16475E-06,10,2.9332E-05,10
หลาน,14,4.74712E-05,21,5.8664E-05,35
หลุด,47,0.000151908,33,9.06626E-05,80
หวง,19,6.32949E-05,0,2.66655E-06,19
ห่วง,33,0.000107601,39,0.000106662,72
ห่วงใย,0,3.16475E-06,154,0.000413315,154
ห้วย,17,5.69655E-05,52,0.000141327,69
ห้วยขวาง,19,6.32949E-05,0,2.66655E-06,19
หวัง,45,0.000145578,53,0.000143993,98
หวั่น,0,3.16475E-06,19,5.33309E-05,19
หวั่นไหว,10,3.48122E-05,0,2.66655E-06,10
หว่า,14,4.74712E-05,15,4.26647E-05,29
หวาน,80,0.000256345,15,4.26647E-05,95
หวานใจ,47,0.000151908,0,2.66655E-06,47
หวีด,27,8.86129E-05,0,2.66655E-06,27
หอ,26,8.54482E-05,0,2.66655E-06,26
ห่อ,13,4.43065E-05,0,2.66655E-06,13
ห้อง,361,0.001145639,24,6.66636E-05,385
ห้องน้ำ,24,7.91187E-05,0,2.66655E-06,24
ห้องเรียน,0,3.16475E-06,14,3.99982E-05,14
ห้องส่วนตัว,14,4.74712E-05,0,2.66655E-06,14
หอม,52,0.000167732,0,2.66655E-06,52
หอย,16,5.38007E-05,0,2.66655E-06,16
หัก,13,4.43065E-05,29,7.99964E-05,42
หัด,10,3.48122E-05,31,8.53295E-05,41
หัน,13,4.43065E-05,10,2.9332E-05,23
หันหน้า,0,3.16475E-06,11,3.19985E-05,11
หัว,137,0.000436735,145,0.000389316,282
หัวข้อ,0,3.16475E-06,19,5.33309E-05,19
หัวใจ,157,0.00050003,47,0.000127994,204
หัวใจสำคัญ,0,3.16475E-06,10,2.9332E-05,10
หัวเราะ,25,8.22834E-05,0,2.66655E-06,25
หัวหน้า,0,3.16475E-06,28,7.73298E-05,28
หัวหน้าพรรค,0,3.16475E-06,53,0.000143993,53
หัส,22,7.27892E-05,0,2.66655E-06,22
หา,475,0.00150642,204,0.000546642,679
ห่า,18,6.01302E-05,14,3.99982E-05,32
ห้า,26,8.54482E-05,17,4.79978E-05,43
หากิน,0,3.16475E-06,11,3.19985E-05,11
หาง,12,4.11417E-05,0,2.66655E-06,12
ห่าง,21,6.96244E-05,0,2.66655E-06,21
ห้าง,36,0.000117096,71,0.000191991,107
ห่างไกล,0,3.16475E-06,14,3.99982E-05,14
หาเงิน,13,4.43065E-05,0,2.66655E-06,13
หาด,19,6.32949E-05,0,2.66655E-06,19
หาดใหญ่,90,0.000287992,0,2.66655E-06,90
ห้าม,71,0.000227862,57,0.00015466,128
หาไม่,12,4.11417E-05,0,2.66655E-06,12
หาย,170,0.000541172,124,0.000333318,294
หาร,15,5.0636E-05,0,2.66655E-06,15
หาเรื่อง,0,3.16475E-06,27,7.46633E-05,27
หาว่า,10,3.48122E-05,11,3.19985E-05,21
หาเสียง,0,3.16475E-06,25,6.93302E-05,25
หำ,12,4.11417E-05,0,2.66655E-06,12
หิน,47,0.000151908,0,2.66655E-06,47
หิมพานต์,13,4.43065E-05,0,2.66655E-06,13
หิว,98,0.00031331,11,3.19985E-05,109
หิ้ว,43,0.000139249,10,2.9332E-05,53
หิวข้าว,12,4.11417E-05,0,2.66655E-06,12
หี,143,0.000455724,0,2.66655E-06,143
หือ,12,4.11417E-05,0,2.66655E-06,12
หุ่น,65,0.000208873,0,2.66655E-06,65
หุ้น,0,3.16475E-06,21,5.8664E-05,21
หุ่นดี,12,4.11417E-05,0,2.66655E-06,12
หู,32,0.000104437,0,2.66655E-06,32
เห,45,0.000145578,57,0.00015466,102
เหงา,202,0.000642444,22,6.13306E-05,224
เหงื่อ,14,4.74712E-05,0,2.66655E-06,14
เห็ด,11,3.7977E-05,0,2.66655E-06,11
เหตุการณ์,0,3.16475E-06,431,0.001151948,431
เห็นใจ,0,3.16475E-06,20,5.59975E-05,20
เห็นด้วย,11,3.7977E-05,107,0.000287987,118
เหนือ,30,9.81072E-05,36,9.86622E-05,66
เหนื่อย,136,0.00043357,37,0.000101329,173
เหม็น,14,4.74712E-05,19,5.33309E-05,33
เหมา,24,7.91187E-05,44,0.000119995,68
เหมาะ,11,3.7977E-05,0,2.66655E-06,11
เหมาะสม,0,3.16475E-06,17,4.79978E-05,17
เหมียน,11,3.7977E-05,0,2.66655E-06,11
เหมียว,11,3.7977E-05,0,2.66655E-06,11
เหมือน,291,0.000924106,154,0.000413315,445
เหมือนกัน,126,0.000401923,107,0.000287987,233
เหมือนกับ,0,3.16475E-06,24,6.66636E-05,24
เหมือนเดิม,43,0.000139249,22,6.13306E-05,65
เหยื่อ,11,3.7977E-05,69,0.000186658,80
เหรอ,104,0.000332298,82,0.000221323,186
เหรียญ,0,3.16475E-06,15,4.26647E-05,15
เหล็ก,0,3.16475E-06,13,3.73316E-05,13
เหล้า,31,0.000101272,0,2.66655E-06,31
เหล่าทัพ,0,3.16475E-06,40,0.000109328,40
เหลือง,27,8.86129E-05,0,2.66655E-06,27
เห้อ,36,0.000117096,10,2.9332E-05,46
เหอะ,30,9.81072E-05,0,2.66655E-06,30
เห่า,0,3.16475E-06,29,7.99964E-05,29
เหี้ย,181,0.000575984,88,0.000237323,269
เหี้ยม,0,3.16475E-06,11,3.19985E-05,11
แห,44,0.000142414,19,5.33309E-05,63
แห่,0,3.16475E-06,16,4.53313E-05,16
แหก,0,3.16475E-06,10,2.9332E-05,10
แหง,13,4.43065E-05,0,2.66655E-06,13
แห้ง,22,7.27892E-05,66,0.000178659,88
แห่งชาติ,204,0.000648773,56,0.000151993,260
แหม,17,5.69655E-05,16,4.53313E-05,33
แหม่ม,0,3.16475E-06,13,3.73316E-05,13
แหล่ง,0,3.16475E-06,30,8.26629E-05,30
แหล่งข่าว,0,3.16475E-06,20,5.59975E-05,20
แหล่งท่องเที่ยว,0,3.16475E-06,11,3.19985E-05,11
แหลม,10,3.48122E-05,0,2.66655E-06,10
แหลมฉบัง,44,0.000142414,11,3.19985E-05,55
แหะๆ,11,3.7977E-05,0,2.66655E-06,11
โห,32,0.000104437,15,4.26647E-05,47
โหด,15,5.0636E-05,16,4.53313E-05,31
โหน,0,3.16475E-06,13,3.73316E-05,13
โหน่ง,0,3.16475E-06,25,6.93302E-05,25
โหมด,15,5.0636E-05,0,2.66655E-06,15
โหลด,17,5.69655E-05,0,2.66655E-06,17
โหวต,36,0.000117096,62,0.000167992,98
ให้การ,0,3.16475E-06,49,0.000133327,49
ให้กำลังใจ,19,6.32949E-05,114,0.000306653,133
ให้เกียรติ,0,3.16475E-06,27,7.46633E-05,27
ให้ความรู้,0,3.16475E-06,24,6.66636E-05,24
ให้ได้,49,0.000158237,69,0.000186658,118
ใหน,24,7.91187E-05,24,6.66636E-05,48
ให้บริการ,0,3.16475E-06,23,6.39971E-05,23
ใหย่,10,3.48122E-05,0,2.66655E-06,10
ให้เหตุผล,0,3.16475E-06,11,3.19985E-05,11
ไห,49,0.000158237,20,5.59975E-05,69
ไห้,39,0.00012659,212,0.000567974,251
ไหนจะ,14,4.74712E-05,0,2.66655E-06,14
ไหม,404,0.001281723,139,0.000373316,543
ไหม้,0,3.16475E-06,65,0.000175992,65
ไหล,27,8.86129E-05,0,2.66655E-06,27
ไหล่,16,5.38007E-05,0,2.66655E-06,16
ไหว,206,0.000655103,25,6.93302E-05,231
ไหว้,40,0.000129755,12,3.46651E-05,52
ไหว้พระ,11,3.7977E-05,0,2.66655E-06,11
อ,221,0.000702574,52,0.000141327,273
อ.บ.,0,3.16475E-06,15,4.26647E-05,15
อ…,0,3.16475E-06,21,5.8664E-05,21
"อ…""",0,3.16475E-06,55,0.000149327,55
อก,58,0.00018672,0,2.66655E-06,58
อกหัก,22,7.27892E-05,0,2.66655E-06,22
อง,10,3.48122E-05,0,2.66655E-06,10
องค์,30,9.81072E-05,0,2.66655E-06,30
องค์กร,0,3.16475E-06,33,9.06626E-05,33
องค์ประชุม,0,3.16475E-06,19,5.33309E-05,19
องคมนตรี,0,3.16475E-06,35,9.59956E-05,35
องศา,12,4.11417E-05,0,2.66655E-06,12
อด,34,0.000110766,11,3.19985E-05,45
อดทน,12,4.11417E-05,0,2.66655E-06,12
อดิ,0,3.16475E-06,27,7.46633E-05,27
อดุลยเดช,22,7.27892E-05,0,2.66655E-06,22
อต,34,0.000110766,0,2.66655E-06,34
อธิบาย,10,3.48122E-05,0,2.66655E-06,10
อธิปไตย,0,3.16475E-06,31,8.53295E-05,31
อน,15,5.0636E-05,49,0.000133327,64
อนาคต,29,9.49424E-05,599,0.001599927,628
อนามัย,28,9.17777E-05,252,0.000674636,280
อนุ,13,4.43065E-05,17,4.79978E-05,30
อนุชน,150,0.000477877,0,2.66655E-06,150
อนุญาต,12,4.11417E-05,16,4.53313E-05,28
อนุทิน,0,3.16475E-06,27,7.46633E-05,27
อนุโมทนา,11,3.7977E-05,11,3.19985E-05,22
อนุรักษ์,0,3.16475E-06,18,5.06644E-05,18
อเนก,0,3.16475E-06,11,3.19985E-05,11
อบ,10,3.48122E-05,0,2.66655E-06,10
อบต.,0,3.16475E-06,15,4.26647E-05,15
อบอุ่น,31,0.000101272,11,3.19985E-05,42
อภิ,0,3.16475E-06,81,0.000218657,81
อภิปราย,0,3.16475E-06,104,0.000279987,104
อม,167,0.000531678,0,2.66655E-06,167
อเมริกัน,0,3.16475E-06,20,5.59975E-05,20
อเมริกา,0,3.16475E-06,10,2.9332E-05,10
อย่า,343,0.001088673,603,0.001610594,946
อยากได้,154,0.000490536,19,5.33309E-05,173
อยากรู้,27,8.86129E-05,12,3.46651E-05,39
อยุ่,27,8.86129E-05,23,6.39971E-05,50
อยุธยา,84,0.000269004,0,2.66655E-06,84
อยู่ดี,18,6.01302E-05,14,3.99982E-05,32
อยู่ดีๆ,11,3.7977E-05,0,2.66655E-06,11
อยู่เลย,23,7.59539E-05,11,3.19985E-05,34
อยู่แล้ว,46,0.000148743,55,0.000149327,101
อร,39,0.00012659,38,0.000103995,77
อรรถ,0,3.16475E-06,35,9.59956E-05,35
อร่อย,242,0.000769034,0,2.66655E-06,242
อริ,0,3.16475E-06,26,7.19967E-05,26
อลังการ,0,3.16475E-06,15,4.26647E-05,15
อ้วก,13,4.43065E-05,0,2.66655E-06,13
อวกาศ,0,3.16475E-06,19,5.33309E-05,19
อ้วน,134,0.000427241,11,3.19985E-05,145
อวบ,50,0.000161402,0,2.66655E-06,50
อวบอ้วน,13,4.43065E-05,0,2.66655E-06,13
อวย,28,9.17777E-05,0,2.66655E-06,28
อวยพร,21,6.96244E-05,0,2.66655E-06,21
อโศก,14,4.74712E-05,0,2.66655E-06,14
อสรพิษ,36,0.000117096,0,2.66655E-06,36
อห,33,0.000107601,0,2.66655E-06,33
ออ,372,0.001180451,42,0.000114661,414
อ่อ,27,8.86129E-05,0,2.66655E-06,27
อ้อ,14,4.74712E-05,0,2.66655E-06,14
อ๋อ,16,5.38007E-05,0,2.66655E-06,16
ออกกำลังกาย,25,8.22834E-05,12,3.46651E-05,37
ออกจาก,33,0.000107601,89,0.000239989,122
ออกแบบ,0,3.16475E-06,12,3.46651E-05,12
ออกมา,103,0.000329134,244,0.000653304,347
ออเดอร์,13,4.43065E-05,0,2.66655E-06,13
ออน,36,0.000117096,10,2.9332E-05,46
อ่อน,15,5.0636E-05,16,4.53313E-05,31
อ้อน,25,8.22834E-05,0,2.66655E-06,25
อ่อนนุช,39,0.00012659,0,2.66655E-06,39
อ่อนโยน,11,3.7977E-05,0,2.66655E-06,11
ออนไลน์,46,0.000148743,105,0.000282654,151
ออฟ,31,0.000101272,0,2.66655E-06,31
อ้อม,21,6.96244E-05,0,2.66655E-06,21
อ่อย,49,0.000158237,0,2.66655E-06,49
ออสเตรเลีย,0,3.16475E-06,42,0.000114661,42
อะ,408,0.001294382,65,0.000175992,473
อ่ะ,453,0.001436795,115,0.000309319,568
อะนะ,0,3.16475E-06,14,3.99982E-05,14
อักเสบ,0,3.16475E-06,18,5.06644E-05,18
อังกฤษ,15,5.0636E-05,18,5.06644E-05,33
อัด,0,3.16475E-06,38,0.000103995,38
อัตรา,0,3.16475E-06,24,6.66636E-05,24
อันดับ,22,7.27892E-05,18,5.06644E-05,40
อันตราย,11,3.7977E-05,36,9.86622E-05,47
อันนี้,96,0.00030698,39,0.000106662,135
อัปเดต,0,3.16475E-06,29,7.99964E-05,29
อัพ,12,4.11417E-05,0,2.66655E-06,12
อา,132,0.000420911,44,0.000119995,176
อ่า,117,0.00037344,0,2.66655E-06,117
อ้า,13,4.43065E-05,0,2.66655E-06,13
อาการ,46,0.000148743,50,0.000135994,96
อากาศ,155,0.000493701,59,0.000159993,214
อาคาร,0,3.16475E-06,53,0.000143993,53
อ่าง,15,5.0636E-05,0,2.66655E-06,15
อ้าง,0,3.16475E-06,62,0.000167992,62
อาจารย์,15,5.0636E-05,42,0.000114661,57
อาชญากร,0,3.16475E-06,17,4.79978E-05,17
อาชีพ,13,4.43065E-05,27,7.46633E-05,40
อาเซียน,0,3.16475E-06,13,3.73316E-05,13
อาญา,0,3.16475E-06,18,5.06644E-05,18
อ่าน,140,0.000446229,318,0.000850628,458
อ่านหนังสือ,10,3.48122E-05,0,2.66655E-06,10
อาบ,15,5.0636E-05,0,2.66655E-06,15
อาบน้ำ,53,0.000170896,0,2.66655E-06,53
อาย,12,4.11417E-05,13,3.73316E-05,25
อ้าย,61,0.000196214,0,2.66655E-06,61
อายุ,71,0.000227862,44,0.000119995,115
อาร์ต,14,4.74712E-05,0,2.66655E-06,14
อารมณ์,34,0.000110766,18,5.06644E-05,52
อารักขา,0,3.16475E-06,16,4.53313E-05,16
อารี,10,3.48122E-05,10,2.9332E-05,20
อ่าว,29,9.49424E-05,12,3.46651E-05,41
อ้าว,32,0.000104437,22,6.13306E-05,54
อาวุธ,0,3.16475E-06,103,0.000277321,103
อาวุธยุทโธปกรณ์,0,3.16475E-06,10,2.9332E-05,10
อาศัย,0,3.16475E-06,18,5.06644E-05,18
อาสา,20,6.64597E-05,349,0.000933291,369
อาสาสมัคร,0,3.16475E-06,18,5.06644E-05,18
อาหาร,71,0.000227862,13,3.73316E-05,84
อาหารเช้า,0,3.16475E-06,10,2.9332E-05,10
อำ,12,4.11417E-05,0,2.66655E-06,12
อำแดง,0,3.16475E-06,19,5.33309E-05,19
อำนวยความสะดวก,0,3.16475E-06,34,9.33291E-05,34
อำนาจ,0,3.16475E-06,20,5.59975E-05,20
อำนาจศาล,0,3.16475E-06,10,2.9332E-05,10
อำเภอ,32,0.000104437,45,0.000122661,77
อิ,117,0.00037344,22,6.13306E-05,139
อิจฉา,25,8.22834E-05,0,2.66655E-06,25
อิด,12,4.11417E-05,0,2.66655E-06,12
อิ๊ด”,0,3.16475E-06,22,6.13306E-05,22
อิทธิ,32,0.000104437,0,2.66655E-06,32
อิน,79,0.00025318,94,0.000253322,173
อินเดีย,0,3.16475E-06,25,6.93302E-05,25
อินโดนีเซีย,0,3.16475E-06,12,3.46651E-05,12
อินทร,0,3.16475E-06,19,5.33309E-05,19
อินทรี,0,3.16475E-06,12,3.46651E-05,12
อิ่ม,32,0.000104437,0,2.66655E-06,32
อิรัก,0,3.16475E-06,11,3.19985E-05,11
อิสระ,34,0.000110766,0,2.66655E-06,34
อิสราเอล,0,3.16475E-06,11,3.19985E-05,11
อิสัส,10,3.48122E-05,0,2.66655E-06,10
อิสาน,0,3.16475E-06,19,5.33309E-05,19
อิหร่าน,0,3.16475E-06,26,7.19967E-05,26
อิอิ,105,0.000335463,31,8.53295E-05,136
อี,311,0.000987401,186,0.000498644,497
อีกครั้ง,32,0.000104437,48,0.000130661,80
อีกต่อไป,0,3.16475E-06,22,6.13306E-05,22
อีกที,38,0.000123425,11,3.19985E-05,49
อีกแล้ว,130,0.000414582,39,0.000106662,169
อีดอก,17,5.69655E-05,16,4.53313E-05,33
อีฟ,12,4.11417E-05,0,2.66655E-06,12
อีโรติก,14,4.74712E-05,0,2.66655E-06,14
อีสาน,0,3.16475E-06,12,3.46651E-05,12
อึ้ง,15,5.0636E-05,0,2.66655E-06,15
อืน,0,3.16475E-06,11,3.19985E-05,11
อืม,10,3.48122E-05,0,2.66655E-06,10
อื้อหือ,12,4.11417E-05,0,2.66655E-06,12
อุ,29,9.49424E-05,0,2.66655E-06,29
อุดม,45,0.000145578,0,2.66655E-06,45
อุดมการณ์,0,3.16475E-06,17,4.79978E-05,17
อุดร,247,0.000784857,0,2.66655E-06,247
อุดรธานี,51,0.000164567,45,0.000122661,96
อุดหนุน,23,7.59539E-05,0,2.66655E-06,23
อุตรดิตถ์,14,4.74712E-05,0,2.66655E-06,14
อุทยาน,0,3.16475E-06,11,3.19985E-05,11
อุทยานแห่งชาติ,0,3.16475E-06,18,5.06644E-05,18
อุทิศ,12,4.11417E-05,53,0.000143993,65
อุ่น,15,5.0636E-05,23,6.39971E-05,38
อุ่นใจ,0,3.16475E-06,15,4.26647E-05,15
อุ่นๆ,21,6.96244E-05,0,2.66655E-06,21
อุบล,43,0.000139249,0,2.66655E-06,43
อุบัติเหตุ,0,3.16475E-06,10,2.9332E-05,10
อุปกรณ์,13,4.43065E-05,49,0.000133327,62
อุปโภค,0,3.16475E-06,23,6.39971E-05,23
อุปสรรค,11,3.7977E-05,0,2.66655E-06,11
อุ้ม,14,4.74712E-05,23,6.39971E-05,37
อุ้ย,14,4.74712E-05,0,2.66655E-06,14
อู,20,6.64597E-05,0,2.66655E-06,20
อู่,0,3.16475E-06,153,0.000410648,153
เอ,46,0.000148743,40,0.000109328,86
เอ้,18,6.01302E-05,0,2.66655E-06,18
เอ๋,12,4.11417E-05,0,2.66655E-06,12
เอก,17,5.69655E-05,13,3.73316E-05,30
เอกสาร,10,3.48122E-05,35,9.59956E-05,45
เอเชีย,0,3.16475E-06,11,3.19985E-05,11
เอน,22,7.27892E-05,0,2.66655E-06,22
เอ็นดู,75,0.000240521,0,2.66655E-06,75
เอฟ,17,5.69655E-05,0,2.66655E-06,17
เอม,19,6.32949E-05,0,2.66655E-06,19
เอย,25,8.22834E-05,0,2.66655E-06,25
เอ่ย,22,7.27892E-05,13,3.73316E-05,35
เอ้ย,60,0.00019305,19,5.33309E-05,79
เอ๊ย,11,3.7977E-05,0,2.66655E-06,11
เอว,45,0.000145578,0,2.66655E-06,45
เอส,22,7.27892E-05,13,3.73316E-05,35
เออ,52,0.000167732,13,3.73316E-05,65
เอ่อ,13,4.43065E-05,0,2.66655E-06,13
เอ๊ะ,28,9.17777E-05,0,2.66655E-06,28
เอ้า,17,5.69655E-05,12,3.46651E-05,29
เอาจริง,28,9.17777E-05,10,2.9332E-05,38
เอาใจ,27,8.86129E-05,0,2.66655E-06,27
เอาใจใส่,0,3.16475E-06,14,3.99982E-05,14
เอาแต่,0,3.16475E-06,18,5.06644E-05,18
เอาผิด,0,3.16475E-06,45,0.000122661,45
เอาไว้,29,9.49424E-05,20,5.59975E-05,49
เอี่ยว,0,3.16475E-06,16,4.53313E-05,16
แอ,96,0.00030698,34,9.33291E-05,130
แอด,134,0.000427241,10,2.9332E-05,144
แอ้ด,0,3.16475E-06,12,3.46651E-05,12
แอดมิน,0,3.16475E-06,13,3.73316E-05,13
แอน,11,3.7977E-05,0,2.66655E-06,11
แอบ,93,0.000297486,22,6.13306E-05,115
แอบอ้าง,0,3.16475E-06,13,3.73316E-05,13
แอพ,17,5.69655E-05,0,2.66655E-06,17
แอร์,29,9.49424E-05,11,3.19985E-05,40
แออัด,0,3.16475E-06,19,5.33309E-05,19
โอ,53,0.000170896,37,0.000101329,90
โอ้,22,7.27892E-05,0,2.66655E-06,22
โอ๋,14,4.74712E-05,0,2.66655E-06,14
โอกาศ,0,3.16475E-06,45,0.000122661,45
โอกาส,31,0.000101272,274,0.0007333,305
โอเค,66,0.000212038,0,2.66655E-06,66
โอชา,0,3.16475E-06,29,7.99964E-05,29
โอน,70,0.000224697,0,2.66655E-06,70
โอบ,13,4.43065E-05,0,2.66655E-06,13
โอม,11,3.7977E-05,0,2.66655E-06,11
โอย,12,4.11417E-05,0,2.66655E-06,12
โอ้ย,101,0.000322804,0,2.66655E-06,101
โอ๊ย,31,0.000101272,0,2.66655E-06,31
โอห์ม,17,5.69655E-05,0,2.66655E-06,17
โอ้โห,15,5.0636E-05,0,2.66655E-06,15
ไอ,238,0.000756375,56,0.000151993,294
ไอ่,0,3.16475E-06,26,7.19967E-05,26
ไอ้,92,0.000294321,240,0.000642638,332
ไอซ์,0,3.16475E-06,34,9.33291E-05,34
ไอดอล,16,5.38007E-05,15,4.26647E-05,31
ไอติม,17,5.69655E-05,0,2.66655E-06,17
ไอโฟน,22,7.27892E-05,0,2.66655E-06,22
ฮ,23,7.59539E-05,0,2.66655E-06,23
ฮ.,0,3.16475E-06,84,0.000226656,84
ฮ่องกง,0,3.16475E-06,20,5.59975E-05,20
ฮอลล์,0,3.16475E-06,11,3.19985E-05,11
ฮะ,70,0.000224697,0,2.66655E-06,70
ฮัก,10,3.48122E-05,0,2.66655E-06,10
ฮัน,11,3.7977E-05,0,2.66655E-06,11
ฮั่น,0,3.16475E-06,148,0.000397315,148
ฮับ,21,6.96244E-05,0,2.66655E-06,21
ฮา,54,0.000174061,45,0.000122661,99
ฮ่า,20,6.64597E-05,0,2.66655E-06,20
ฮิ,10,3.48122E-05,0,2.66655E-06,10
ฮี,15,5.0636E-05,0,2.66655E-06,15
ฮีโร่,0,3.16475E-06,35,9.59956E-05,35
ฮึ,19,6.32949E-05,0,2.66655E-06,19
ฮือ,55,0.000177226,0,2.66655E-06,55
เฮงซวย,0,3.16475E-06,27,7.46633E-05,27
เฮลิคอปเตอร์,0,3.16475E-06,50,0.000135994,50
เฮ้อ,17,5.69655E-05,0,2.66655E-06,17
เฮีย,64,0.000205709,0,2.66655E-06,64
แฮ,43,0.000139249,16,4.53313E-05,59
แฮปปี้,17,5.69655E-05,0,2.66655E-06,17
โฮมสเตย์,10,3.48122E-05,0,2.66655E-06,10
ไฮ,38,0.000123425,0,2.66655E-06,38
ฯ”,0,3.16475E-06,12,3.46651E-05,12
ะ,24,7.91187E-05,0,2.66655E-06,24
ะะ,20,6.64597E-05,0,2.66655E-06,20
า,142,0.000452559,12,3.46651E-05,154
าา,155,0.000493701,0,2.66655E-06,155
าาา,72,0.000231027,10,2.9332E-05,82
าาาา,32,0.000104437,0,2.66655E-06,32
าาาาา,30,9.81072E-05,0,2.66655E-06,30
"ิ…""",0,3.16475E-06,15,4.26647E-05,15
ี…,0,3.16475E-06,22,6.13306E-05,22
ื่…,0,3.16475E-06,12,3.46651E-05,12
ื่ยมๆ,0,3.16475E-06,10,2.9332E-05,10
ุ,0,3.16475E-06,37,0.000101329,37
ๆ​,14,4.74712E-05,0,2.66655E-06,14
ๆ.,12,4.11417E-05,0,2.66655E-06,12
ๆ?,14,4.74712E-05,0,2.66655E-06,14
ๆ??,10,3.48122E-05,0,2.66655E-06,10
ๆคน,17,5.69655E-05,0,2.66655E-06,17
ๆๆ,188,0.000598137,29,7.99964E-05,217
ๆๆๆ,117,0.00037344,11,3.19985E-05,128
ๆๆๆๆ,34,0.000110766,0,2.66655E-06,34
ๆๆๆๆๆ,13,4.43065E-05,0,2.66655E-06,13
��𝗳,0,3.16475E-06,14,3.99982E-05,14
��𝗶𝘃𝗲𝗿,0,3.16475E-06,14,3.99982E-05,14
��𝗶𝗱𝗲,0,3.16475E-06,14,3.99982E-05,14
��𝗵𝗲,0,3.16475E-06,21,5.8664E-05,21
��,49,0.000158237,0,2.66655E-06,49
��🇭,0,3.16475E-06,178,0.000477312,178
"🇹🇭""""",0,3.16475E-06,15,4.26647E-05,15
��🇭🤝🇺🇸#,0,3.16475E-06,41,0.000111995,41
��,11,3.7977E-05,0,2.66655E-06,11
��🍌,0,3.16475E-06,10,2.9332E-05,10
��,12,4.11417E-05,0,2.66655E-06,12
��💕,21,6.96244E-05,0,2.66655E-06,21
��,12,4.11417E-05,0,2.66655E-06,12
��,10,3.48122E-05,10,2.9332E-05,20
��,13,4.43065E-05,0,2.66655E-06,13
��,16,5.38007E-05,0,2.66655E-06,16
��,16,5.38007E-05,78,0.000210657,94
��,11,3.7977E-05,0,2.66655E-06,11
��,16,5.38007E-05,0,2.66655E-06,16
��,12,4.11417E-05,0,2.66655E-06,12
��,13,4.43065E-05,0,2.66655E-06,13
��,30,9.81072E-05,95,0.000255988,125
��,26,8.54482E-05,50,0.000135994,76
��,17,5.69655E-05,0,2.66655E-06,17
��,17,5.69655E-05,0,2.66655E-06,17
��,0,3.16475E-06,23,6.39971E-05,23
��,0,3.16475E-06,11,3.19985E-05,11
��,0,3.16475E-06,20,5.59975E-05,20
��,32,0.000104437,0,2.66655E-06,32
��😁,11,3.7977E-05,0,2.66655E-06,11
��,77,0.00024685,0,2.66655E-06,77
��😂,21,6.96244E-05,0,2.66655E-06,21
��😂😂,27,8.86129E-05,0,2.66655E-06,27
��,27,8.86129E-05,0,2.66655E-06,27
��,27,8.86129E-05,0,2.66655E-06,27
��,34,0.000110766,11,3.19985E-05,45
��😊,13,4.43065E-05,0,2.66655E-06,13
��,11,3.7977E-05,0,2.66655E-06,11
��,21,6.96244E-05,0,2.66655E-06,21
��,18,6.01302E-05,0,2.66655E-06,18
��,13,4.43065E-05,0,2.66655E-06,13
��,41,0.000132919,0,2.66655E-06,41
��😭,15,5.0636E-05,0,2.66655E-06,15
��😭😭,20,6.64597E-05,0,2.66655E-06,20
��,11,3.7977E-05,0,2.66655E-06,11
��,0,3.16475E-06,34,9.33291E-05,34
��,16,5.38007E-05,0,2.66655E-06,16
��🏻,11,3.7977E-05,12,3.46651E-05,23
��,0,3.16475E-06,11,3.19985E-05,11
��,12,4.11417E-05,0,2.66655E-06,12
��,11,3.7977E-05,0,2.66655E-06,11
��,65,0.000208873,0,2.66655E-06,65
��🤣,23,7.59539E-05,0,2.66655E-06,23
��🤣🤣,24,7.91187E-05,0,2.66655E-06,24
��,22,7.27892E-05,0,2.66655E-06,22
��,39,0.00012659,14,3.99982E-05,53
��,50,0.000161402,0,2.66655E-06,50
,0,3.16475E-06,0,2.66655E-06,
Total,310543,,369579,,1360244
